上海金仕达卫宁软件股份有限公司	﻿上海金仕达卫宁软件股份有限公司
卫宁软件	﻿上海金仕达卫宁软件股份有限公司
天水华天科技股份有限公司	天水华天科技股份有限公司
华天科技	天水华天科技股份有限公司
中国电力报	中国电力报
中国电力报	中国电力报
中保康联人寿保险有限公司	中保康联人寿保险有限公司
中保康联	中保康联人寿保险有限公司
广西投资集团有限公司	广西投资集团有限公司
广西投资集团	广西投资集团有限公司
西南证券股份有限公司	西南证券股份有限公司
西南证券	西南证券股份有限公司
中国有色金属建设股份有限公司	中国有色金属建设股份有限公司
中色股份	中国有色金属建设股份有限公司
广东美的电器股份有限公司	广东美的电器股份有限公司
美的电器	广东美的电器股份有限公司
金杯汽车股份有限公司	金杯汽车股份有限公司
金杯汽车	金杯汽车股份有限公司
MorganStanley	MorganStanley
摩根士丹利	MorganStanley
现代投资股份有限公司	现代投资股份有限公司
现代投资	现代投资股份有限公司
华电国际电力股份有限公司	华电国际电力股份有限公司
华电国际	华电国际电力股份有限公司
天弘基金管理有限公司	天弘基金管理有限公司
天弘基金	天弘基金管理有限公司
中国房地产开发集团公司	中国房地产开发集团公司
中房集团	中国房地产开发集团公司
上海康达化工新材料股份有限公司	上海康达化工新材料股份有限公司
康达新材	上海康达化工新材料股份有限公司
安徽国通高新管业股份有限公司	安徽国通高新管业股份有限公司
国通管业	安徽国通高新管业股份有限公司
湖北台基半导体股份有限公司	湖北台基半导体股份有限公司
台基股份	湖北台基半导体股份有限公司
浙江海利得新材料股份有限公司	浙江海利得新材料股份有限公司
海利得	浙江海利得新材料股份有限公司
百思买	百思买
百思买	百思买
欣龙控股(集团)股份有限公司	欣龙控股(集团)股份有限公司
欣龙控股	欣龙控股(集团)股份有限公司
上海交大南洋股份有限公司	上海交大南洋股份有限公司
交大南洋	上海交大南洋股份有限公司
上海鼎立科技发展集团股份有限公司	上海鼎立科技发展集团股份有限公司
鼎立股份	上海鼎立科技发展集团股份有限公司
嘉禾娱乐事业有限公司	嘉禾娱乐事业有限公司
嘉禾娱乐	嘉禾娱乐事业有限公司
际华集团股份有限公司	际华集团股份有限公司
际华集团	际华集团股份有限公司
雨润集团	雨润集团
雨润集团	雨润集团
拜耳公司	拜耳公司
拜耳公司	拜耳公司
上海良信电器股份有限公司	上海良信电器股份有限公司
良信电器	上海良信电器股份有限公司
北京国际信托有限公司	北京国际信托有限公司
北京国际信托	北京国际信托有限公司
招商局集团公司	招商局集团公司
招商局	招商局集团公司
浙江开山压缩机股份有限公司	浙江开山压缩机股份有限公司
开山股份	浙江开山压缩机股份有限公司
荆楚网	荆楚网
荆楚网	荆楚网
山东金岭矿业股份有限公司	山东金岭矿业股份有限公司
金岭矿业	山东金岭矿业股份有限公司
华灿光电股份有限公司	华灿光电股份有限公司
华灿光电	华灿光电股份有限公司
广东威华股份有限公司	广东威华股份有限公司
威华股份	广东威华股份有限公司
美国达美航空公司	美国达美航空公司
达美航空	美国达美航空公司
美国斯伦贝谢公司	美国斯伦贝谢公司
斯伦贝谢	美国斯伦贝谢公司
天津市海运股份有限公司	天津市海运股份有限公司
天津海运.*S\\*ST天海	天津市海运股份有限公司
北京北辰实业股份有限公司	北京北辰实业股份有限公司
北辰实业	北京北辰实业股份有限公司
中国水利报	中国水利报
中国水利报	中国水利报
深圳市国际企业股份有限公司	深圳市国际企业股份有限公司
深国商.*\\*ST国商	深圳市国际企业股份有限公司
恒康医疗集团股份有限公司	恒康医疗集团股份有限公司
恒康医疗	恒康医疗集团股份有限公司
中体产业集团股份有限公司	中体产业集团股份有限公司
中体产业	中体产业集团股份有限公司
上海开能环保设备股份有限公司	上海开能环保设备股份有限公司
开能环保	上海开能环保设备股份有限公司
凤凰卫视控股有限公司	凤凰卫视控股有限公司
凤凰卫视	凤凰卫视控股有限公司
中信银行股份有限公司	中信银行股份有限公司
中信银行	中信银行股份有限公司
万鸿集团股份有限公司	万鸿集团股份有限公司
万鸿集团	万鸿集团股份有限公司
上海三爱富新材料股份有限公司	上海三爱富新材料股份有限公司
三爱富	上海三爱富新材料股份有限公司
河北大午农牧集团有限公司	河北大午农牧集团有限公司
大午农牧	河北大午农牧集团有限公司
奥克斯集团	奥克斯集团
奥克斯	奥克斯集团
深圳泰然集团股份有限公司	深圳泰然集团股份有限公司
泰然集团	深圳泰然集团股份有限公司
福建龙洲运输股份有限公司	福建龙洲运输股份有限公司
龙洲股份	福建龙洲运输股份有限公司
衣恋时装上海有限公司	衣恋时装上海有限公司
衣恋集团	衣恋时装上海有限公司
北京京客隆商业集团股份有限公司	北京京客隆商业集团股份有限公司
京客隆	北京京客隆商业集团股份有限公司
承德新新钒钛股份有限公司	承德新新钒钛股份有限公司
承德钒钛	承德新新钒钛股份有限公司
深圳市特尔佳科技股份有限公司	深圳市特尔佳科技股份有限公司
特尔佳	深圳市特尔佳科技股份有限公司
中国化学工程股份有限公司	中国化学工程股份有限公司
中国化学	中国化学工程股份有限公司
北京东方园林股份有限公司	北京东方园林股份有限公司
东方园林	北京东方园林股份有限公司
北京华胜天成科技股份有限公司	北京华胜天成科技股份有限公司
华胜天成	北京华胜天成科技股份有限公司
唐山冀东水泥股份有限公司	唐山冀东水泥股份有限公司
冀东水泥	唐山冀东水泥股份有限公司
北京韩建集团有限公司	北京韩建集团有限公司
韩建集团	北京韩建集团有限公司
华商网	华商网
华商网	华商网
湖北新华光信息材料股份有限公司	湖北新华光信息材料股份有限公司
新华光	湖北新华光信息材料股份有限公司
日本三井住友保险公司	日本三井住友保险公司
三井住友	日本三井住友保险公司
重庆市涪陵榨菜集团股份有限公司	重庆市涪陵榨菜集团股份有限公司
涪陵榨菜	重庆市涪陵榨菜集团股份有限公司
远光软件股份有限公司	远光软件股份有限公司
远光软件	远光软件股份有限公司
量子高科（中国）生物股份有限公司	量子高科（中国）生物股份有限公司
量子高科	量子高科（中国）生物股份有限公司
西门子集团	西门子集团
西门子	西门子集团
日本第一生命保险公司	日本第一生命保险公司
第一生命	日本第一生命保险公司
广宇集团股份有限公司	广宇集团股份有限公司
广宇集团	广宇集团股份有限公司
上海建工集团股份有限公司	上海建工集团股份有限公司
上海建工	上海建工集团股份有限公司
上海久游网络科技有限公司	上海久游网络科技有限公司
久游网	上海久游网络科技有限公司
哈尔滨九洲电气股份有限公司	哈尔滨九洲电气股份有限公司
九洲电气	哈尔滨九洲电气股份有限公司
上海金陵股份有限公司	上海金陵股份有限公司
上海金陵	上海金陵股份有限公司
鸿博股份有限公司	鸿博股份有限公司
鸿博股份	鸿博股份有限公司
洛阳栾川钼业集团股份有限公司	洛阳栾川钼业集团股份有限公司
洛阳钼业	洛阳栾川钼业集团股份有限公司
甘肃皇台酒业股份有限公司	甘肃皇台酒业股份有限公司
皇台酒业.*\\*ST皇台	甘肃皇台酒业股份有限公司
法国欧尚集团	法国欧尚集团
欧尚集团	法国欧尚集团
黑龙江省科利华网络股份有限公司	黑龙江省科利华网络股份有限公司
科利华	黑龙江省科利华网络股份有限公司
凯诺科技股份有限公司	凯诺科技股份有限公司
凯诺科技	凯诺科技股份有限公司
北京华业地产股份有限公司	北京华业地产股份有限公司
华业地产	北京华业地产股份有限公司
深圳信立泰药业股份有限公司	深圳信立泰药业股份有限公司
信立泰.*信立泰药业	深圳信立泰药业股份有限公司
天津一汽夏利汽车股份有限公司	天津一汽夏利汽车股份有限公司
一汽夏利	天津一汽夏利汽车股份有限公司
大连热电股份有限公司	大连热电股份有限公司
大连热电	大连热电股份有限公司
国元证券股份有限公司	国元证券股份有限公司
国元证券	国元证券股份有限公司
中国太平洋保险（集团）股份有限公司	中国太平洋保险（集团）股份有限公司
太平洋保险	中国太平洋保险（集团）股份有限公司
广州钢铁股份有限公司	广州钢铁股份有限公司
广钢股份	广州钢铁股份有限公司
鲁信创业投资集团股份有限公司	鲁信创业投资集团股份有限公司
鲁信创投	鲁信创业投资集团股份有限公司
太原双塔刚玉股份有限公司	太原双塔刚玉股份有限公司
太原刚玉	太原双塔刚玉股份有限公司
包头北方创业股份有限公司	包头北方创业股份有限公司
北方创业	包头北方创业股份有限公司
西南药业股份有限公司	西南药业股份有限公司
西南药业	西南药业股份有限公司
东华软件股份公司	东华软件股份公司
东华软件	东华软件股份公司
江苏裕兴薄膜科技股份有限公司	江苏裕兴薄膜科技股份有限公司
裕兴股份	江苏裕兴薄膜科技股份有限公司
中国电力建设股份有限公司	中国电力建设股份有限公司
中国电建	中国电力建设股份有限公司
海伦钢琴股份有限公司	海伦钢琴股份有限公司
海伦钢琴	海伦钢琴股份有限公司
慕尼黑再保险公司	慕尼黑再保险公司
慕尼黑再保险	慕尼黑再保险公司
宁波能之光新材料科技有限公司	宁波能之光新材料科技有限公司
能之光	宁波能之光新材料科技有限公司
上海世茂股份有限公司	上海世茂股份有限公司
世茂股份	上海世茂股份有限公司
江苏江南水务股份有限公司	江苏江南水务股份有限公司
江南水务	江苏江南水务股份有限公司
武汉锅炉股份有限公司	武汉锅炉股份有限公司
武锅股份.*\\*ST武锅B	武汉锅炉股份有限公司
麦考林	麦考林
麦考林	麦考林
当当网络科技有限公司	当当网络科技有限公司
当当网	当当网络科技有限公司
华商基金管理有限公司	华商基金管理有限公司
华商基金	华商基金管理有限公司
河南同力水泥股份有限公司	河南同力水泥股份有限公司
同力水泥	河南同力水泥股份有限公司
招商局能源运输股份有限公司	招商局能源运输股份有限公司
招商轮船	招商局能源运输股份有限公司
广东冠昊生物科技股份有限公司	广东冠昊生物科技股份有限公司
冠昊生物	广东冠昊生物科技股份有限公司
大连大显控股股份有限公司	大连大显控股股份有限公司
大连控股	大连大显控股股份有限公司
上海凯宝药业股份有限公司	上海凯宝药业股份有限公司
上海凯宝	上海凯宝药业股份有限公司
安徽省科苑集团股份有限公司	安徽省科苑集团股份有限公司
\\*ST科苑	安徽省科苑集团股份有限公司
英美烟草集团	英美烟草集团
英美烟草	英美烟草集团
山东华泰纸业股份有限公司	山东华泰纸业股份有限公司
华泰股份	山东华泰纸业股份有限公司
新疆城建（集团）股份有限公司	新疆城建（集团）股份有限公司
新疆城建	新疆城建（集团）股份有限公司
北京同仁堂股份有限公司	北京同仁堂股份有限公司
同仁堂	北京同仁堂股份有限公司
明基电通	明基电通
明基	明基电通
中国保险行业协会	中国保险行业协会
中国保险行业协会	中国保险行业协会
牡丹江恒丰纸业股份有限公司	牡丹江恒丰纸业股份有限公司
恒丰纸业	牡丹江恒丰纸业股份有限公司
北京金隅嘉业房地产开发有限公司	北京金隅嘉业房地产开发有限公司
金隅嘉业	北京金隅嘉业房地产开发有限公司
长城基金管理有限公司	长城基金管理有限公司
长城基金	长城基金管理有限公司
德国电信股份公司	德国电信股份公司
德国电信	德国电信股份公司
鞍钢股份有限公司	鞍钢股份有限公司
鞍钢股份.*\\*ST鞍钢	鞍钢股份有限公司
国电南瑞科技股份有限公司	国电南瑞科技股份有限公司
国电南瑞	国电南瑞科技股份有限公司
交通银行股份有限公司	交通银行股份有限公司
交通银行	交通银行股份有限公司
上海开创国际海洋资源股份有限公司	上海开创国际海洋资源股份有限公司
开创国际	上海开创国际海洋资源股份有限公司
潍柴动力股份有限公司	潍柴动力股份有限公司
潍柴动力	潍柴动力股份有限公司
戴尔计算机公司	戴尔计算机公司
戴尔	戴尔计算机公司
上海城投控股股份有限公司	上海城投控股股份有限公司
城投控股	上海城投控股股份有限公司
河池网	河池网
河池网	河池网
美国电报电话公司	美国电报电话公司
AT＆T	美国电报电话公司
深圳市京基房地产开发有限公司	深圳市京基房地产开发有限公司
京基地产	深圳市京基房地产开发有限公司
投资有道	投资有道
投资有道	投资有道
天津市中诺典当行有限公司	天津市中诺典当行有限公司
中诺典当	天津市中诺典当行有限公司
jiefangribao	jiefangribao
解放日报	jiefangribao
乐视网信息技术(北京)股份有限公司	乐视网信息技术(北京)股份有限公司
乐视网	乐视网信息技术(北京)股份有限公司
西宁特殊钢股份有限公司	西宁特殊钢股份有限公司
西宁特钢	西宁特殊钢股份有限公司
重庆涪陵电力实业股份有限公司	重庆涪陵电力实业股份有限公司
涪陵电力	重庆涪陵电力实业股份有限公司
山东墨龙石油机械股份有限公司	山东墨龙石油机械股份有限公司
山东墨龙	山东墨龙石油机械股份有限公司
浙江信联股份有限公司	浙江信联股份有限公司
信联股份.*\\*ST信联	浙江信联股份有限公司
浙江杭叉工程机械股份有限公司	浙江杭叉工程机械股份有限公司
杭叉工程机械	浙江杭叉工程机械股份有限公司
荷兰阿霍德集团	荷兰阿霍德集团
荷兰阿霍德	荷兰阿霍德集团
《北京商报》社	《北京商报》社
北京商报	《北京商报》社
广东汕头超声电子股份有限公司	广东汕头超声电子股份有限公司
超声电子	广东汕头超声电子股份有限公司
大连银行股份有限公司	大连银行股份有限公司
大连银行	大连银行股份有限公司
泰国正大集团	泰国正大集团
正大集团	泰国正大集团
华谊兄弟传媒股份有限公司	华谊兄弟传媒股份有限公司
华谊兄弟	华谊兄弟传媒股份有限公司
上海大众公用事业集团股份有限公司	上海大众公用事业集团股份有限公司
大众公用	上海大众公用事业集团股份有限公司
茂业物流股份有限公司	茂业物流股份有限公司
茂业物流	茂业物流股份有限公司
株洲旗滨集团股份有限公司	株洲旗滨集团股份有限公司
旗滨集团	株洲旗滨集团股份有限公司
粤海投资有限公司	粤海投资有限公司
粤海投资	粤海投资有限公司
台湾威盛电子股份有限公司	台湾威盛电子股份有限公司
威盛电子	台湾威盛电子股份有限公司
温州银行股份有限公司	温州银行股份有限公司
温州银行	温州银行股份有限公司
西安宏盛科技发展股份有限公司	西安宏盛科技发展股份有限公司
宏盛科技	西安宏盛科技发展股份有限公司
卧龙地产集团股份有限公司	卧龙地产集团股份有限公司
卧龙地产	卧龙地产集团股份有限公司
建龙集团	建龙集团
建龙集团	建龙集团
杭州宋城旅游发展股份有限公司	杭州宋城旅游发展股份有限公司
宋城股份	杭州宋城旅游发展股份有限公司
法国雷诺集团	法国雷诺集团
雷诺	法国雷诺集团
大恒新纪元科技股份有限公司	大恒新纪元科技股份有限公司
大恒科技	大恒新纪元科技股份有限公司
武汉祥龙电业股份有限公司	武汉祥龙电业股份有限公司
祥龙电业	武汉祥龙电业股份有限公司
上海紫江企业集团股份有限公司	上海紫江企业集团股份有限公司
紫江企业	上海紫江企业集团股份有限公司
云南临沧鑫圆锗业股份有限公司	云南临沧鑫圆锗业股份有限公司
云南锗业	云南临沧鑫圆锗业股份有限公司
中粮生物化学(安徽)股份有限公司	中粮生物化学(安徽)股份有限公司
中粮生化	中粮生物化学(安徽)股份有限公司
攀钢集团四川长城特殊钢股份有限公司	攀钢集团四川长城特殊钢股份有限公司
长城股份	攀钢集团四川长城特殊钢股份有限公司
中国航空集团公司	中国航空集团公司
中国航空	中国航空集团公司
云南铜业股份有限公司	云南铜业股份有限公司
云南铜业	云南铜业股份有限公司
广州阳普医疗科技股份有限公司	广州阳普医疗科技股份有限公司
阳普医疗	广州阳普医疗科技股份有限公司
上海锦江国际实业投资股份有限公司	上海锦江国际实业投资股份有限公司
锦江投资	上海锦江国际实业投资股份有限公司
万家基金管理有限公司	万家基金管理有限公司
万家基金	万家基金管理有限公司
中航光电科技股份有限公司	中航光电科技股份有限公司
中航光电	中航光电科技股份有限公司
金山软件股份有限公司	金山软件股份有限公司
金山软件	金山软件股份有限公司
国际商报	国际商报
国际商报	国际商报
ChrrstianDior	ChrrstianDior
迪奥	ChrrstianDior
百度	百度
百度	百度
荣安地产股份有限公司	荣安地产股份有限公司
荣安地产	荣安地产股份有限公司
中国东方资产管理公司	中国东方资产管理公司
东方资产	中国东方资产管理公司
北京易华录信息技术股份有限公司	北京易华录信息技术股份有限公司
易华录	北京易华录信息技术股份有限公司
卡巴斯基	卡巴斯基
卡巴斯基	卡巴斯基
申科滑动轴承股份有限公司	申科滑动轴承股份有限公司
申科股份	申科滑动轴承股份有限公司
河南平高电气股份有限公司	河南平高电气股份有限公司
平高电气	河南平高电气股份有限公司
蓝驰创投基金	蓝驰创投基金
蓝驰创投	蓝驰创投基金
三星电子	三星电子
三星电子	三星电子
青岛东软载波科技股份有限公司	青岛东软载波科技股份有限公司
东软载波	青岛东软载波科技股份有限公司
《董事会》杂志社	《董事会》杂志社
《董事会》	《董事会》杂志社
中国海洋石油总公司	中国海洋石油总公司
中海油	中国海洋石油总公司
宁波杉杉股份有限公司	宁波杉杉股份有限公司
杉杉股份	宁波杉杉股份有限公司
江苏天瑞仪器股份有限公司	江苏天瑞仪器股份有限公司
天瑞仪器	江苏天瑞仪器股份有限公司
烟台泰和新材料股份有限公司	烟台泰和新材料股份有限公司
泰和新材	烟台泰和新材料股份有限公司
北京汉鼎世纪咨询有限公司	北京汉鼎世纪咨询有限公司
汉鼎咨询	北京汉鼎世纪咨询有限公司
华芳集团	华芳集团
华芳集团	华芳集团
杭州士兰微电子股份有限公司	杭州士兰微电子股份有限公司
士兰微	杭州士兰微电子股份有限公司
美国联合航空	美国联合航空
联合航空	美国联合航空
纽约商品交易所	纽约商品交易所
纽约商品交易所	纽约商品交易所
天津九安医疗电子股份有限公司	天津九安医疗电子股份有限公司
九安医疗	天津九安医疗电子股份有限公司
华为技术有限公司	华为技术有限公司
华为	华为技术有限公司
波士顿咨询公司	波士顿咨询公司
波士顿咨询	波士顿咨询公司
攀钢集团钒钛资源股份有限公司	攀钢集团钒钛资源股份有限公司
攀钢钒钛	攀钢集团钒钛资源股份有限公司
华立地产集团有限公司	华立地产集团有限公司
华立地产	华立地产集团有限公司
广东溢多利生物科技股份有限公司	广东溢多利生物科技股份有限公司
溢多利	广东溢多利生物科技股份有限公司
深圳市捷顺科技实业股份有限公司	深圳市捷顺科技实业股份有限公司
捷顺科技	深圳市捷顺科技实业股份有限公司
奥维通信股份有限公司	奥维通信股份有限公司
奥维通信	奥维通信股份有限公司
云南云天化股份有限公司	云南云天化股份有限公司
云天化	云南云天化股份有限公司
山东德棉股份有限公司	山东德棉股份有限公司
德棉股份	山东德棉股份有限公司
米其林	米其林
米其林	米其林
卓达集团	卓达集团
卓达集团	卓达集团
福耀玻璃工业集团股份有限公司	福耀玻璃工业集团股份有限公司
福耀玻璃	福耀玻璃工业集团股份有限公司
北京粮食集团	北京粮食集团
京粮集团	北京粮食集团
中航电测仪器股份有限公司	中航电测仪器股份有限公司
中航电测	中航电测仪器股份有限公司
北海银河产业投资股份有限公司	北海银河产业投资股份有限公司
银河投资	北海银河产业投资股份有限公司
荷兰农业合作银行	荷兰农业合作银行
拉博银行	荷兰农业合作银行
武汉金运激光股份有限公司	武汉金运激光股份有限公司
金运激光	武汉金运激光股份有限公司
上海钢联电子商务股份有限公司	上海钢联电子商务股份有限公司
上海钢联	上海钢联电子商务股份有限公司
安信信托投资股份有限公司	安信信托投资股份有限公司
安信信托	安信信托投资股份有限公司
第一财经日报	第一财经日报
第一财经日报	第一财经日报
九龙仓集团有限公司	九龙仓集团有限公司
九龙仓	九龙仓集团有限公司
宁波港股份有限公司	宁波港股份有限公司
宁波港	宁波港股份有限公司
大唐电信科技股份有限公司	大唐电信科技股份有限公司
大唐电信	大唐电信科技股份有限公司
江苏通润装备科技股份有限公司	江苏通润装备科技股份有限公司
通润装备	江苏通润装备科技股份有限公司
天津长荣印刷设备股份有限公司	天津长荣印刷设备股份有限公司
长荣股份	天津长荣印刷设备股份有限公司
天平汽车保险股份有限公司	天平汽车保险股份有限公司
天平汽车险	天平汽车保险股份有限公司
深圳市赢时胜信息技术股份有限公司	深圳市赢时胜信息技术股份有限公司
赢时胜	深圳市赢时胜信息技术股份有限公司
黑石集团	黑石集团
黑石	黑石集团
永诚财产保险股份有限公司	永诚财产保险股份有限公司
永诚财险	永诚财产保险股份有限公司
桑德环境资源股份有限公司	桑德环境资源股份有限公司
桑德环境	桑德环境资源股份有限公司
苏州工业园区和顺电气股份有限公司	苏州工业园区和顺电气股份有限公司
和顺电气	苏州工业园区和顺电气股份有限公司
成都旭光电子股份有限公司	成都旭光电子股份有限公司
旭光股份	成都旭光电子股份有限公司
西藏银河科技发展股份有限公司	西藏银河科技发展股份有限公司
西藏发展	西藏银河科技发展股份有限公司
北京金隅股份有限公司	北京金隅股份有限公司
金隅股份	北京金隅股份有限公司
广东博信投资控股股份有限公司	广东博信投资控股股份有限公司
博信股份	广东博信投资控股股份有限公司
南京中央商场(集团)股份有限公司	南京中央商场(集团)股份有限公司
中央商场	南京中央商场(集团)股份有限公司
上海贝岭股份有限公司	上海贝岭股份有限公司
上海贝岭	上海贝岭股份有限公司
华泰柏瑞基金管理有限公司	华泰柏瑞基金管理有限公司
华泰柏瑞	华泰柏瑞基金管理有限公司
深圳市富安娜家居用品股份有限公司	深圳市富安娜家居用品股份有限公司
富安娜	深圳市富安娜家居用品股份有限公司
浙江上风实业股份有限公司	浙江上风实业股份有限公司
上风高科	浙江上风实业股份有限公司
联合利华公司（UnileverN.V，原译尤尼莱佛公司）	联合利华公司（UnileverN.V，原译尤尼莱佛公司）
联合利华	联合利华公司（UnileverN.V，原译尤尼莱佛公司）
酒鬼酒股份有限公司	酒鬼酒股份有限公司
酒鬼酒	酒鬼酒股份有限公司
华晨中国汽车控股有限公司	华晨中国汽车控股有限公司
华晨中国	华晨中国汽车控股有限公司
成都硅宝科技股份有限公司	成都硅宝科技股份有限公司
硅宝科技	成都硅宝科技股份有限公司
佛山市海天调味食品股份有限公司	佛山市海天调味食品股份有限公司
海天味业	佛山市海天调味食品股份有限公司
杭州味全生技食品有限公司	杭州味全生技食品有限公司
味全	杭州味全生技食品有限公司
北京启明星辰信息技术股份有限公司	北京启明星辰信息技术股份有限公司
启明星辰	北京启明星辰信息技术股份有限公司
广州恒运企业集团股份有限公司	广州恒运企业集团股份有限公司
穗恒运.*穗恒运A.*穗恒运Ａ	广州恒运企业集团股份有限公司
中国国旅股份有限公司	中国国旅股份有限公司
中国国旅	中国国旅股份有限公司
云南沃森生物技术有限公司	云南沃森生物技术有限公司
沃森生物	云南沃森生物技术有限公司
第九城市计算机技术咨询上海有限公司	第九城市计算机技术咨询上海有限公司
第九城市	第九城市计算机技术咨询上海有限公司
中航地产股份有限公司	中航地产股份有限公司
中航地产	中航地产股份有限公司
成都前锋电子股份有限公司	成都前锋电子股份有限公司
前锋股份.*S前锋	成都前锋电子股份有限公司
熊猫烟花集团股份有限公司	熊猫烟花集团股份有限公司
熊猫烟花	熊猫烟花集团股份有限公司
信质电机股份有限公司	信质电机股份有限公司
信质电机	信质电机股份有限公司
五芳斋集团股份有限公司	五芳斋集团股份有限公司
五芳斋	五芳斋集团股份有限公司
华孚色纺股份有限公司	华孚色纺股份有限公司
华孚色纺	华孚色纺股份有限公司
大商集团股份有限公司	大商集团股份有限公司
大商股份	大商集团股份有限公司
中航动力控制股份有限公司	中航动力控制股份有限公司
中航动控	中航动力控制股份有限公司
湖北洪湖生态农业股份有限公司	湖北洪湖生态农业股份有限公司
生态农业	湖北洪湖生态农业股份有限公司
bandaochenbao	bandaochenbao
半岛晨报	bandaochenbao
昆仑健康保险股份有限公司	昆仑健康保险股份有限公司
昆仑健康保险	昆仑健康保险股份有限公司
深圳奥特迅电力设备股份有限公司	深圳奥特迅电力设备股份有限公司
奥特迅	深圳奥特迅电力设备股份有限公司
北京捷成世纪科技股份有限公司	北京捷成世纪科技股份有限公司
捷成股份	北京捷成世纪科技股份有限公司
腾达建设集团股份有限公司	腾达建设集团股份有限公司
腾达建设	腾达建设集团股份有限公司
长沙中联重工科技发展股份有限公司	长沙中联重工科技发展股份有限公司
中联重科	长沙中联重工科技发展股份有限公司
深圳市天健(集团)股份有限公司	深圳市天健(集团)股份有限公司
深天健	深圳市天健(集团)股份有限公司
浙江开尔新材料股份有限公司	浙江开尔新材料股份有限公司
开尔新材	浙江开尔新材料股份有限公司
浙江久立特材科技股份有限公司	浙江久立特材科技股份有限公司
久立特材	浙江久立特材科技股份有限公司
南方汇通股份有限公司	南方汇通股份有限公司
南方汇通	南方汇通股份有限公司
德国巴斯夫集团	德国巴斯夫集团
巴斯夫	德国巴斯夫集团
美国吉列公司	美国吉列公司
吉列公司	美国吉列公司
凌源钢铁股份有限公司	凌源钢铁股份有限公司
凌钢股份	凌源钢铁股份有限公司
常州亚玛顿股份有限公司	常州亚玛顿股份有限公司
亚玛顿	常州亚玛顿股份有限公司
中国石油报	中国石油报
中国石油报	中国石油报
连云港黄海机械股份有限公司	连云港黄海机械股份有限公司
黄海机械	连云港黄海机械股份有限公司
北京华宇软件股份有限公司	北京华宇软件股份有限公司
华宇软件	北京华宇软件股份有限公司
中国华融资产管理公司	中国华融资产管理公司
华融资产	中国华融资产管理公司
北京汇源饮料食品集团有限公司	北京汇源饮料食品集团有限公司
汇源集团	北京汇源饮料食品集团有限公司
浙江中设房地产开发有限公司	浙江中设房地产开发有限公司
浙江中设	浙江中设房地产开发有限公司
上海输配电股份有限公司	上海输配电股份有限公司
上电股份	上海输配电股份有限公司
海南民源现代农业发展股份有限公司	海南民源现代农业发展股份有限公司
琼民源	海南民源现代农业发展股份有限公司
百洋水产集团股份有限公司	百洋水产集团股份有限公司
百洋股份	百洋水产集团股份有限公司
珠海中富实业股份有限公司	珠海中富实业股份有限公司
珠海中富	珠海中富实业股份有限公司
荣盛石化股份有限公司	荣盛石化股份有限公司
荣盛石化	荣盛石化股份有限公司
博时基金管理有限公司	博时基金管理有限公司
博时基金	博时基金管理有限公司
四川水井坊股份有限公司	四川水井坊股份有限公司
水井坊	四川水井坊股份有限公司
上海爱使股份有限公司	上海爱使股份有限公司
爱使股份	上海爱使股份有限公司
中国天津宝成机械集团有限公司	中国天津宝成机械集团有限公司
宝成集团	中国天津宝成机械集团有限公司
诺安基金管理有限公司	诺安基金管理有限公司
诺安基金	诺安基金管理有限公司
山东龙泉管道工程股份有限公司	山东龙泉管道工程股份有限公司
龙泉股份	山东龙泉管道工程股份有限公司
辽宁奥克化学股份有限公司	辽宁奥克化学股份有限公司
奥克股份	辽宁奥克化学股份有限公司
太平人寿	太平人寿
太平人寿	太平人寿
广西丰林木业集团股份有限公司	广西丰林木业集团股份有限公司
丰林集团	广西丰林木业集团股份有限公司
成都地奥集团	成都地奥集团
地奥集团	成都地奥集团
中青旅控股股份有限公司	中青旅控股股份有限公司
中青旅	中青旅控股股份有限公司
江苏华西村股份有限公司	江苏华西村股份有限公司
华西股份	江苏华西村股份有限公司
韩国SK集团	韩国SK集团
SK集团	韩国SK集团
广东长城集团股份有限公司	广东长城集团股份有限公司
长城集团	广东长城集团股份有限公司
江苏旋力集团股份有限公司	江苏旋力集团股份有限公司
旋力集团	江苏旋力集团股份有限公司
大连智云自动化装备股份有限公司	大连智云自动化装备股份有限公司
智云股份	大连智云自动化装备股份有限公司
西陇化工股份有限公司	西陇化工股份有限公司
西陇化工	西陇化工股份有限公司
凯鹏华盈创业投资基金	凯鹏华盈创业投资基金
凯鹏华盈	凯鹏华盈创业投资基金
中国远洋运输（集团）总公司	中国远洋运输（集团）总公司
中远集团	中国远洋运输（集团）总公司
长治钢铁集团有限公司	长治钢铁集团有限公司
长治钢铁	长治钢铁集团有限公司
河北财达证券经纪有限责任公司	河北财达证券经纪有限责任公司
财达证券	河北财达证券经纪有限责任公司
铜陵三佳科技股份有限公司	铜陵三佳科技股份有限公司
三佳科技	铜陵三佳科技股份有限公司
武汉中商集团股份有限公司	武汉中商集团股份有限公司
武汉中商	武汉中商集团股份有限公司
恒天天鹅股份有限公司	恒天天鹅股份有限公司
恒天天鹅	恒天天鹅股份有限公司
徐州工程机械科技股份有限公司	徐州工程机械科技股份有限公司
徐工科技	徐州工程机械科技股份有限公司
上海国际港务(集团)股份有限公司	上海国际港务(集团)股份有限公司
上港集团	上海国际港务(集团)股份有限公司
山东黄金矿业股份有限公司	山东黄金矿业股份有限公司
山东黄金	山东黄金矿业股份有限公司
西藏城市发展投资股份有限公司	西藏城市发展投资股份有限公司
西藏城投	西藏城市发展投资股份有限公司
深圳市特力(集团)股份有限公司	深圳市特力(集团)股份有限公司
深特力.*特力Ａ	深圳市特力(集团)股份有限公司
北京四方继保自动化股份有限公司	北京四方继保自动化股份有限公司
四方股份	北京四方继保自动化股份有限公司
上海华峰超纤材料股份有限公司	上海华峰超纤材料股份有限公司
华峰超纤	上海华峰超纤材料股份有限公司
乐凯胶片股份有限公司	乐凯胶片股份有限公司
乐凯胶片	乐凯胶片股份有限公司
惠誉国际信用评级有限公司	惠誉国际信用评级有限公司
惠誉	惠誉国际信用评级有限公司
春秋航空有限公司	春秋航空有限公司
春秋航空	春秋航空有限公司
西安飞机国际航空制造股份有限公司	西安飞机国际航空制造股份有限公司
西飞国际	西安飞机国际航空制造股份有限公司
上投摩根基金管理有限公司	上投摩根基金管理有限公司
上投摩根基金	上投摩根基金管理有限公司
张家港保税科技股份有限公司	张家港保税科技股份有限公司
保税科技	张家港保税科技股份有限公司
蓝星化工新材料股份有限公司	蓝星化工新材料股份有限公司
蓝星新材	蓝星化工新材料股份有限公司
广东梅雁吉祥水电股份有限公司	广东梅雁吉祥水电股份有限公司
梅雁吉祥	广东梅雁吉祥水电股份有限公司
清华科技创业投资有限公司	清华科技创业投资有限公司
清华创投	清华科技创业投资有限公司
上海科泰电源股份有限公司	上海科泰电源股份有限公司
科泰电源	上海科泰电源股份有限公司
山推工程机械股份有限公司	山推工程机械股份有限公司
山推股份	山推工程机械股份有限公司
厦门大洲兴业能源控股股份有限公司	厦门大洲兴业能源控股股份有限公司
兴业能源	厦门大洲兴业能源控股股份有限公司
美国马拉松石油公司	美国马拉松石油公司
马拉松石油	美国马拉松石油公司
福建福人木业有限公司	福建福人木业有限公司
福人木业	福建福人木业有限公司
江苏连云港港口股份有限公司	江苏连云港港口股份有限公司
连云港	江苏连云港港口股份有限公司
北京立思辰科技股份有限公司	北京立思辰科技股份有限公司
立思辰	北京立思辰科技股份有限公司
上海耀皮玻璃集团股份有限公司	上海耀皮玻璃集团股份有限公司
耀皮玻璃	上海耀皮玻璃集团股份有限公司
天安中国投资有限公司	天安中国投资有限公司
天安中国	天安中国投资有限公司
葵花药业集团有限公司	葵花药业集团有限公司
葵花药业	葵花药业集团有限公司
安徽德力日用玻璃股份有限公司	安徽德力日用玻璃股份有限公司
德力股份	安徽德力日用玻璃股份有限公司
合生创展集团有限公司	合生创展集团有限公司
合生创展	合生创展集团有限公司
adidasGroup	adidasGroup
阿迪达斯	adidasGroup
太原狮头水泥股份有限公司	太原狮头水泥股份有限公司
狮头股份	太原狮头水泥股份有限公司
天地科技股份有限公司	天地科技股份有限公司
天地科技	天地科技股份有限公司
上海姚记扑克股份有限公司	上海姚记扑克股份有限公司
姚记扑克	上海姚记扑克股份有限公司
俄罗斯卢克石油公司	俄罗斯卢克石油公司
卢克	俄罗斯卢克石油公司
国脉科技股份有限公司	国脉科技股份有限公司
国脉科技	国脉科技股份有限公司
福建中能电气股份有限公司	福建中能电气股份有限公司
中能电气	福建中能电气股份有限公司
荣盛房地产发展股份有限公司	荣盛房地产发展股份有限公司
荣盛发展	荣盛房地产发展股份有限公司
莱芜钢铁集团有限公司	莱芜钢铁集团有限公司
莱芜钢铁	莱芜钢铁集团有限公司
浙江亚厦装饰股份有限公司	浙江亚厦装饰股份有限公司
亚厦股份	浙江亚厦装饰股份有限公司
PSAPeugeotCitron	PSAPeugeotCitron
标致	PSAPeugeotCitron
芜湖亚夏汽车股份有限公司	芜湖亚夏汽车股份有限公司
亚夏汽车	芜湖亚夏汽车股份有限公司
日本电报电话公司	日本电报电话公司
日本电报电话	日本电报电话公司
深圳市沃尔核材股份有限公司	深圳市沃尔核材股份有限公司
沃尔核材	深圳市沃尔核材股份有限公司
四川西昌电力股份有限公司	四川西昌电力股份有限公司
西昌电力	四川西昌电力股份有限公司
江苏南方轴承股份有限公司	江苏南方轴承股份有限公司
南方轴承	江苏南方轴承股份有限公司
东方基金管理有限公司	东方基金管理有限公司
东方基金	东方基金管理有限公司
中国产经新闻	中国产经新闻
中国产经新闻	中国产经新闻
苏州扬子江新型材料股份有限公司	苏州扬子江新型材料股份有限公司
扬子新材	苏州扬子江新型材料股份有限公司
创元科技股份有限公司	创元科技股份有限公司
创元科技	创元科技股份有限公司
嘉士伯	嘉士伯
嘉士伯	嘉士伯
天津银行	天津银行
天津银行	天津银行
武汉力源信息技术股份有限公司	武汉力源信息技术股份有限公司
力源信息	武汉力源信息技术股份有限公司
金元证券股份有限公司	金元证券股份有限公司
金元证券	金元证券股份有限公司
江苏双良集团有限公司	江苏双良集团有限公司
双良集团	江苏双良集团有限公司
诚志股份有限公司	诚志股份有限公司
诚志股份	诚志股份有限公司
InternationalDataGroup	InternationalDataGroup
IDG	InternationalDataGroup
山东浪潮齐鲁软件产业股份有限公司	山东浪潮齐鲁软件产业股份有限公司
浪潮软件	山东浪潮齐鲁软件产业股份有限公司
亿阳信通股份有限公司	亿阳信通股份有限公司
亿阳信通	亿阳信通股份有限公司
广州卡奴迪路服饰股份有限公司	广州卡奴迪路服饰股份有限公司
卡奴迪路	广州卡奴迪路服饰股份有限公司
钱江水利开发股份有限公司	钱江水利开发股份有限公司
钱江水利	钱江水利开发股份有限公司
东莞市合高玻璃纤维复合材料有限公司	东莞市合高玻璃纤维复合材料有限公司
合高实业	东莞市合高玻璃纤维复合材料有限公司
法国国营铁路公司	法国国营铁路公司
SNCF	法国国营铁路公司
湖北双环科技股份有限公司	湖北双环科技股份有限公司
双环科技	湖北双环科技股份有限公司
财付通	财付通
财付通	财付通
福建众和股份有限公司	福建众和股份有限公司
众和股份	福建众和股份有限公司
无锡市太极实业股份有限公司	无锡市太极实业股份有限公司
太极实业	无锡市太极实业股份有限公司
建信基金管理有限责任公司	建信基金管理有限责任公司
建信基金	建信基金管理有限责任公司
利达光电股份有限公司	利达光电股份有限公司
利达光电	利达光电股份有限公司
长江精工钢结构(集团)股份有限公司	长江精工钢结构(集团)股份有限公司
精工钢构	长江精工钢结构(集团)股份有限公司
苏州锦富新材料股份有限公司	苏州锦富新材料股份有限公司
锦富新材	苏州锦富新材料股份有限公司
浙江网盛生意宝股份有限公司	浙江网盛生意宝股份有限公司
生意宝	浙江网盛生意宝股份有限公司
苹果电脑公司	苹果电脑公司
苹果公司	苹果电脑公司
史丹利化肥股份有限公司	史丹利化肥股份有限公司
史丹利	史丹利化肥股份有限公司
天津三英焊业股份有限公司	天津三英焊业股份有限公司
三英焊业	天津三英焊业股份有限公司
华邦颖泰股份有限公司	华邦颖泰股份有限公司
华邦颖泰	华邦颖泰股份有限公司
巴西淡水河谷公司	巴西淡水河谷公司
淡水河谷	巴西淡水河谷公司
甲骨文公司	甲骨文公司
甲骨文	甲骨文公司
华安基金管理有限公司	华安基金管理有限公司
华安基金	华安基金管理有限公司
石家庄中煤装备制造股份有限公司	石家庄中煤装备制造股份有限公司
石中装备	石家庄中煤装备制造股份有限公司
山东兴民钢圈股份有限公司	山东兴民钢圈股份有限公司
兴民钢圈	山东兴民钢圈股份有限公司
中国国际海运集装箱(集团)股份有限公司	中国国际海运集装箱(集团)股份有限公司
中集集团	中国国际海运集装箱(集团)股份有限公司
华润（集团）有限公司	华润（集团）有限公司
华润集团	华润（集团）有限公司
宁波联合集团股份有限公司	宁波联合集团股份有限公司
宁波联合	宁波联合集团股份有限公司
台湾远传电信公司	台湾远传电信公司
远传电信	台湾远传电信公司
崇义章源钨业股份有限公司	崇义章源钨业股份有限公司
章源钨业	崇义章源钨业股份有限公司
海南天涯在线网络科技有限公司	海南天涯在线网络科技有限公司
天涯在线	海南天涯在线网络科技有限公司
广州中山医医药有限公司	广州中山医医药有限公司
中山医医药	广州中山医医药有限公司
江苏综艺股份有限公司	江苏综艺股份有限公司
综艺股份	江苏综艺股份有限公司
中英人寿保险有限公司	中英人寿保险有限公司
中英人寿	中英人寿保险有限公司
湖北广济药业股份有限公司	湖北广济药业股份有限公司
广济药业	湖北广济药业股份有限公司
新疆中泰化学股份有限公司	新疆中泰化学股份有限公司
中泰化学	新疆中泰化学股份有限公司
环旭电子股份有限公司	环旭电子股份有限公司
环旭电子	环旭电子股份有限公司
苏州万龙电气集团股份有限公司	苏州万龙电气集团股份有限公司
万龙集团	苏州万龙电气集团股份有限公司
南方基金管理有限公司	南方基金管理有限公司
南方基金	南方基金管理有限公司
沧州大化股份有限公司	沧州大化股份有限公司
沧州大化	沧州大化股份有限公司
浙江亚太药业股份有限公司	浙江亚太药业股份有限公司
亚太药业	浙江亚太药业股份有限公司
黄山旅游发展股份有限公司	黄山旅游发展股份有限公司
黄山旅游	黄山旅游发展股份有限公司
福建南纺股份有限公司	福建南纺股份有限公司
福建南纺	福建南纺股份有限公司
湖南天一科技股份有限公司	湖南天一科技股份有限公司
天一科技.*\\*ST天一	湖南天一科技股份有限公司
东方锅炉集团股份有限公司	东方锅炉集团股份有限公司
东方锅炉	东方锅炉集团股份有限公司
巨力索具股份有限公司	巨力索具股份有限公司
巨力索具	巨力索具股份有限公司
江苏金飞达服装股份有限公司	江苏金飞达服装股份有限公司
金飞达	江苏金飞达服装股份有限公司
宏润建设集团股份有限公司	宏润建设集团股份有限公司
宏润建设	宏润建设集团股份有限公司
深圳国际控股有限公司	深圳国际控股有限公司
深圳国际	深圳国际控股有限公司
中国振华集团科技股份有限公司	中国振华集团科技股份有限公司
振华科技	中国振华集团科技股份有限公司
江苏正大天晴药业股份有限公司	江苏正大天晴药业股份有限公司
正大天晴	江苏正大天晴药业股份有限公司
深圳市盐田港股份有限公司	深圳市盐田港股份有限公司
盐田港	深圳市盐田港股份有限公司
广州珠江啤酒股份有限公司	广州珠江啤酒股份有限公司
珠江啤酒	广州珠江啤酒股份有限公司
世纪金源集团	世纪金源集团
世纪金源	世纪金源集团
万福生科(湖南)农业开发股份有限公司	万福生科(湖南)农业开发股份有限公司
万福生科	万福生科(湖南)农业开发股份有限公司
广东美雅集团股份有限公司	广东美雅集团股份有限公司
\\*ST美雅	广东美雅集团股份有限公司
中国人民财产保险股份有限公司	中国人民财产保险股份有限公司
人保财险	中国人民财产保险股份有限公司
德国联邦铁路公司	德国联邦铁路公司
联邦铁路	德国联邦铁路公司
上海城开集团有限公司	上海城开集团有限公司
城开集团	上海城开集团有限公司
中国旺旺控股有限公司	中国旺旺控股有限公司
中国旺旺	中国旺旺控股有限公司
中国石化仪征化纤股份有限公司	中国石化仪征化纤股份有限公司
仪征化纤	中国石化仪征化纤股份有限公司
西安陕鼓动力股份有限公司	西安陕鼓动力股份有限公司
陕鼓动力	西安陕鼓动力股份有限公司
上海理财网络信息有限公司	上海理财网络信息有限公司
理财周刊	上海理财网络信息有限公司
上海延华智能科技(集团)股份有限公司	上海延华智能科技(集团)股份有限公司
延华智能	上海延华智能科技(集团)股份有限公司
四川和邦股份有限公司	四川和邦股份有限公司
和邦股份	四川和邦股份有限公司
信达地产股份有限公司	信达地产股份有限公司
信达地产	信达地产股份有限公司
国联证券股份有限公司	国联证券股份有限公司
国联证券	国联证券股份有限公司
石家庄北国人百集团有限责任公司	石家庄北国人百集团有限责任公司
北人集团	石家庄北国人百集团有限责任公司
瑞茂通供应链管理股份有限公司	瑞茂通供应链管理股份有限公司
瑞茂通	瑞茂通供应链管理股份有限公司
湖北宜昌交运集团股份有限公司	湖北宜昌交运集团股份有限公司
宜昌交运	湖北宜昌交运集团股份有限公司
江西西林科股份有限公司	江西西林科股份有限公司
西林科	江西西林科股份有限公司
嘉禾人寿保险股份有限公司	嘉禾人寿保险股份有限公司
嘉禾人寿	嘉禾人寿保险股份有限公司
名流置业集团股份有限公司	名流置业集团股份有限公司
名流置业	名流置业集团股份有限公司
科达集团股份有限公司	科达集团股份有限公司
科达股份.*科达集团	科达集团股份有限公司
中国石化报	中国石化报
中国石化报	中国石化报
海南大东海旅游中心股份有限公司	海南大东海旅游中心股份有限公司
大东海.*大东海A	海南大东海旅游中心股份有限公司
新疆天业股份有限公司	新疆天业股份有限公司
新疆天业	新疆天业股份有限公司
上海东方明珠(集团)股份有限公司	上海东方明珠(集团)股份有限公司
东方明珠	上海东方明珠(集团)股份有限公司
汇丰集团	汇丰集团
汇丰集团	汇丰集团
抚顺特殊钢股份有限公司	抚顺特殊钢股份有限公司
抚顺特钢	抚顺特殊钢股份有限公司
广东银禧科技股份有限公司	广东银禧科技股份有限公司
银禧科技	广东银禧科技股份有限公司
中利科技集团股份有限公司	中利科技集团股份有限公司
中利科技	中利科技集团股份有限公司
沈阳菲菲澳家现代农业股份有限公司	沈阳菲菲澳家现代农业股份有限公司
菲菲农业	沈阳菲菲澳家现代农业股份有限公司
中国质量报	中国质量报
中国质量报	中国质量报
中国水电华亭发电有限责任公司	中国水电华亭发电有限责任公司
华亭发电	中国水电华亭发电有限责任公司
中信重工机械股份有限公司	中信重工机械股份有限公司
中信重工	中信重工机械股份有限公司
深圳万讯自控股份有限公司	深圳万讯自控股份有限公司
万讯自控	深圳万讯自控股份有限公司
上海海立集团股份有限公司	上海海立集团股份有限公司
海立股份	上海海立集团股份有限公司
烟台东诚生化股份有限公司	烟台东诚生化股份有限公司
东诚生化	烟台东诚生化股份有限公司
江苏霞客环保色纺股份有限公司	江苏霞客环保色纺股份有限公司
霞客环保	江苏霞客环保色纺股份有限公司
中粮屯河股份有限公司	中粮屯河股份有限公司
中粮屯河	中粮屯河股份有限公司
焦作万方铝业股份有限公司	焦作万方铝业股份有限公司
焦作万方	焦作万方铝业股份有限公司
海航国际酒店管理有限公司	海航国际酒店管理有限公司
海航酒店	海航国际酒店管理有限公司
雀巢公司	雀巢公司
雀巢公司	雀巢公司
伊莱克斯	伊莱克斯
伊莱克斯	伊莱克斯
江门市科恒实业股份有限公司	江门市科恒实业股份有限公司
科恒股份	江门市科恒实业股份有限公司
中牧实业股份有限公司	中牧实业股份有限公司
中牧股份	中牧实业股份有限公司
金谷源控股股份有限公司	金谷源控股股份有限公司
金谷源	金谷源控股股份有限公司
深圳市天地集团股份有限公司	深圳市天地集团股份有限公司
深天地A	深圳市天地集团股份有限公司
药明康德新药开发有限公司	药明康德新药开发有限公司
药明康德	药明康德新药开发有限公司
西藏奇正藏药股份有限公司	西藏奇正藏药股份有限公司
奇正藏药	西藏奇正藏药股份有限公司
中国吉林网	中国吉林网
中国吉林网	中国吉林网
四川九洲电器企业集团	四川九洲电器企业集团
九洲电器	四川九洲电器企业集团
上海泰胜风能装备股份有限公司	上海泰胜风能装备股份有限公司
泰胜风能	上海泰胜风能装备股份有限公司
星美联合股份有限公司	星美联合股份有限公司
星美联合	星美联合股份有限公司
江门甘蔗化工厂集团股份有限公司	江门甘蔗化工厂集团股份有限公司
\\*ST甘化	江门甘蔗化工厂集团股份有限公司
广西桂冠电力股份有限公司	广西桂冠电力股份有限公司
桂冠电力	广西桂冠电力股份有限公司
宁夏英力特化工股份有限公司	宁夏英力特化工股份有限公司
英力特	宁夏英力特化工股份有限公司
陕西秦岭水泥(集团)股份有限公司	陕西秦岭水泥(集团)股份有限公司
秦岭水泥	陕西秦岭水泥(集团)股份有限公司
万华化学集团股份有限公司	万华化学集团股份有限公司
万华化学	万华化学集团股份有限公司
天津中新药业集团股份有限公司	天津中新药业集团股份有限公司
中新药业.*\\*ST中新	天津中新药业集团股份有限公司
长春高新技术产业(集团)股份有限公司	长春高新技术产业(集团)股份有限公司
长春高新	长春高新技术产业(集团)股份有限公司
均瑶集团	均瑶集团
均瑶集团	均瑶集团
四川成发航空科技股份有限公司	四川成发航空科技股份有限公司
成发科技	四川成发航空科技股份有限公司
南京中北(集团)股份有限公司	南京中北(集团)股份有限公司
南京中北	南京中北(集团)股份有限公司
北汽福田汽车股份有限公司	北汽福田汽车股份有限公司
福田汽车	北汽福田汽车股份有限公司
香港信兴集团	香港信兴集团
信兴集团	香港信兴集团
金威啤酒集团有限公司	金威啤酒集团有限公司
金威啤酒	金威啤酒集团有限公司
迪斯尼公司	迪斯尼公司
迪斯尼	迪斯尼公司
北大医药股份有限公司	北大医药股份有限公司
北大医药	北大医药股份有限公司
成都市路桥工程股份有限公司	成都市路桥工程股份有限公司
成都路桥	成都市路桥工程股份有限公司
山西潞安矿业集团有限责任公司	山西潞安矿业集团有限责任公司
潞安集团	山西潞安矿业集团有限责任公司
清科集团	清科集团
清科	清科集团
新世纪基金管理有限公司	新世纪基金管理有限公司
新世纪基金	新世纪基金管理有限公司
湖南国光瓷业集团股份有限公司	湖南国光瓷业集团股份有限公司
国光瓷业	湖南国光瓷业集团股份有限公司
九洲发展有限公司	九洲发展有限公司
九洲发展	九洲发展有限公司
浙江海纳电气有限公司	浙江海纳电气有限公司
浙江海纳	浙江海纳电气有限公司
浙江美欣达印染集团股份有限公司	浙江美欣达印染集团股份有限公司
美欣达	浙江美欣达印染集团股份有限公司
深圳市新天下集团有限公司	深圳市新天下集团有限公司
深圳新天下	深圳市新天下集团有限公司
成都天兴仪表股份有限公司	成都天兴仪表股份有限公司
天兴仪表	成都天兴仪表股份有限公司
义乌华鼎锦纶股份有限公司	义乌华鼎锦纶股份有限公司
华鼎股份	义乌华鼎锦纶股份有限公司
金卡高科技股份有限公司	金卡高科技股份有限公司
金卡股份	金卡高科技股份有限公司
贝因美婴童食品股份有限公司	贝因美婴童食品股份有限公司
贝因美	贝因美婴童食品股份有限公司
泰亚鞋业股份有限公司	泰亚鞋业股份有限公司
泰亚股份.*泰亚鞋业	泰亚鞋业股份有限公司
江苏正昌集团有限公司	江苏正昌集团有限公司
正昌集团	江苏正昌集团有限公司
福建九州集团股份有限公司	福建九州集团股份有限公司
九州股份	福建九州集团股份有限公司
广东宝丽华集团有限公司	广东宝丽华集团有限公司
宝丽华集团	广东宝丽华集团有限公司
泰尔重工股份有限公司	泰尔重工股份有限公司
泰尔重工	泰尔重工股份有限公司
创智信息科技股份有限公司	创智信息科技股份有限公司
创智科技	创智信息科技股份有限公司
湖南胜景山河生物科技股份有限公司	湖南胜景山河生物科技股份有限公司
胜景山河	湖南胜景山河生物科技股份有限公司
大连科冕木业股份有限公司	大连科冕木业股份有限公司
科冕木业	大连科冕木业股份有限公司
三普药业股份有限公司	三普药业股份有限公司
三普药业	三普药业股份有限公司
瑞士历峰集团（RichemontGroup）	瑞士历峰集团（RichemontGroup）
历峰集团	瑞士历峰集团（RichemontGroup）
神马实业股份有限公司	神马实业股份有限公司
神马股份.*神马实业	神马实业股份有限公司
广发银行	广发银行
广发银行	广发银行
深圳市华新股份有限公司	深圳市华新股份有限公司
SST华新	深圳市华新股份有限公司
浙江森马服饰股份有限公司	浙江森马服饰股份有限公司
森马服饰.*森马股份	浙江森马服饰股份有限公司
光大证券股份有限公司	光大证券股份有限公司
光大证券	光大证券股份有限公司
包头钢铁（集团）有限责任公司	包头钢铁（集团）有限责任公司
包钢	包头钢铁（集团）有限责任公司
深圳市机场股份有限公司	深圳市机场股份有限公司
深圳机场	深圳市机场股份有限公司
江苏法尔胜股份有限公司	江苏法尔胜股份有限公司
法尔胜	江苏法尔胜股份有限公司
东睦新材料集团股份有限公司	东睦新材料集团股份有限公司
东睦股份	东睦新材料集团股份有限公司
新世界中国地产有限公司	新世界中国地产有限公司
新世界中国地产	新世界中国地产有限公司
康佳集团股份有限公司	康佳集团股份有限公司
康佳集团.*深康佳A.*深康佳Ａ	康佳集团股份有限公司
江苏恒瑞医药股份有限公司	江苏恒瑞医药股份有限公司
恒瑞医药	江苏恒瑞医药股份有限公司
鼎盛天工工程机械股份有限公司	鼎盛天工工程机械股份有限公司
鼎盛天工	鼎盛天工工程机械股份有限公司
力帆实业(集团)股份有限公司	力帆实业(集团)股份有限公司
力帆股份	力帆实业(集团)股份有限公司
中成进出口股份有限公司	中成进出口股份有限公司
中成股份	中成进出口股份有限公司
北海港股份有限公司	北海港股份有限公司
北海港	北海港股份有限公司
中国长城资产管理公司	中国长城资产管理公司
长城资产	中国长城资产管理公司
成都鹏博士电信传媒集团股份有限公司	成都鹏博士电信传媒集团股份有限公司
鹏博士	成都鹏博士电信传媒集团股份有限公司
南京中电环保股份有限公司	南京中电环保股份有限公司
中电环保	南京中电环保股份有限公司
吉林紫鑫药业股份有限公司	吉林紫鑫药业股份有限公司
紫鑫药业	吉林紫鑫药业股份有限公司
天津港股份有限公司	天津港股份有限公司
天津港	天津港股份有限公司
惠州硕贝德无线科技股份有限公司	惠州硕贝德无线科技股份有限公司
硕贝德	惠州硕贝德无线科技股份有限公司
安邦财产保险股份有限公司	安邦财产保险股份有限公司
安邦财险	安邦财产保险股份有限公司
假日100天	假日100天
假日100天	假日100天
成都银行股份有限公司	成都银行股份有限公司
成都银行	成都银行股份有限公司
民生证券有限责任公司	民生证券有限责任公司
民生证券	民生证券有限责任公司
中国检验认证集团有限公司	中国检验认证集团有限公司
中国检验认证	中国检验认证集团有限公司
泰达宏利基金管理有限公司	泰达宏利基金管理有限公司
泰达宏利	泰达宏利基金管理有限公司
广东钢铁集团有限公司	广东钢铁集团有限公司
广钢集团	广东钢铁集团有限公司
重庆梅安森科技股份有限公司	重庆梅安森科技股份有限公司
梅安森	重庆梅安森科技股份有限公司
本溪钢铁（集团）有限责任公司	本溪钢铁（集团）有限责任公司
本溪钢铁	本溪钢铁（集团）有限责任公司
甘肃上峰水泥股份有限公司	甘肃上峰水泥股份有限公司
上峰水泥	甘肃上峰水泥股份有限公司
台塑石化公司	台塑石化公司
台塑石化	台塑石化公司
阳光城集团股份有限公司	阳光城集团股份有限公司
阳光城	阳光城集团股份有限公司
深圳市长城投资控股股份有限公司	深圳市长城投资控股股份有限公司
深长城	深圳市长城投资控股股份有限公司
河南恒星科技股份有限公司	河南恒星科技股份有限公司
恒星科技	河南恒星科技股份有限公司
中国民族证券有限责任公司	中国民族证券有限责任公司
民族证券	中国民族证券有限责任公司
平安证券有限责任公司	平安证券有限责任公司
平安证券	平安证券有限责任公司
江苏九九久科技股份有限公司	江苏九九久科技股份有限公司
九九久	江苏九九久科技股份有限公司
北新集团建材股份有限公司	北新集团建材股份有限公司
北新建材	北新集团建材股份有限公司
山西晋城无烟煤矿业集团有限责任公司	山西晋城无烟煤矿业集团有限责任公司
晋煤集团	山西晋城无烟煤矿业集团有限责任公司
包头东宝生物技术股份有限公司	包头东宝生物技术股份有限公司
东宝生物	包头东宝生物技术股份有限公司
香港庄胜集团	香港庄胜集团
庄胜集团	香港庄胜集团
红云烟草	红云烟草
红云烟草	红云烟草
丰田汽车株式会社	丰田汽车株式会社
丰田汽车	丰田汽车株式会社
浙江永强集团股份有限公司	浙江永强集团股份有限公司
浙江永强	浙江永强集团股份有限公司
英杰华集团简介	英杰华集团简介
英杰华	英杰华集团简介
华西证券有限责任公司	华西证券有限责任公司
华西证券	华西证券有限责任公司
华能国际电力股份有限公司	华能国际电力股份有限公司
华能国际	华能国际电力股份有限公司
秦皇岛奥通贸易有限公司	秦皇岛奥通贸易有限公司
奥通贸易	秦皇岛奥通贸易有限公司
四川西部资源控股股份有限公司	四川西部资源控股股份有限公司
西部资源	四川西部资源控股股份有限公司
浙江中国小商品城集团股份有限公司	浙江中国小商品城集团股份有限公司
小商品城	浙江中国小商品城集团股份有限公司
南山集团	南山集团
南山集团	南山集团
鲁丰环保科技股份有限公司	鲁丰环保科技股份有限公司
鲁丰环保	鲁丰环保科技股份有限公司
上海世博（集团）有限公司	上海世博（集团）有限公司
世博集团	上海世博（集团）有限公司
宁波维科置业有限公司	宁波维科置业有限公司
维科置业	宁波维科置业有限公司
国金通用基金管理有限公司	国金通用基金管理有限公司
国金通用	国金通用基金管理有限公司
瑞泰人寿保险有限公司	瑞泰人寿保险有限公司
瑞泰人寿	瑞泰人寿保险有限公司
法国电力公司	法国电力公司
法国电力公司	法国电力公司
武汉钢铁集团公司	武汉钢铁集团公司
武汉钢铁	武汉钢铁集团公司
华安财产保险股份有限公司	华安财产保险股份有限公司
华安保险	华安财产保险股份有限公司
山东工程机械集团有限公司	山东工程机械集团有限公司
山工集团	山东工程机械集团有限公司
珠海振戎公司	珠海振戎公司
珠海振戎	珠海振戎公司
中航重机股份有限公司	中航重机股份有限公司
中航重机	中航重机股份有限公司
中南出版传媒集团股份有限公司	中南出版传媒集团股份有限公司
中南传媒	中南出版传媒集团股份有限公司
铜陵有色金属集团股份有限公司	铜陵有色金属集团股份有限公司
铜陵有色	铜陵有色金属集团股份有限公司
厦门乾照光电股份有限公司	厦门乾照光电股份有限公司
乾照光电	厦门乾照光电股份有限公司
常州光洋轴承股份有限公司	常州光洋轴承股份有限公司
光洋股份	常州光洋轴承股份有限公司
裕泰典当行	裕泰典当行
裕泰典当行	裕泰典当行
江苏宝利沥青股份有限公司	江苏宝利沥青股份有限公司
宝利沥青	江苏宝利沥青股份有限公司
烟台张裕葡萄酿酒股份有限公司	烟台张裕葡萄酿酒股份有限公司
张裕.*张裕A.*张裕Ａ	烟台张裕葡萄酿酒股份有限公司
乐山电力股份有限公司	乐山电力股份有限公司
乐山电力	乐山电力股份有限公司
科大智能科技股份有限公司	科大智能科技股份有限公司
科大智能	科大智能科技股份有限公司
天津鹏翎胶管股份有限公司	天津鹏翎胶管股份有限公司
鹏翎股份	天津鹏翎胶管股份有限公司
锦湖轮胎（中国）公司	锦湖轮胎（中国）公司
锦湖轮胎	锦湖轮胎（中国）公司
人民网-国际金融报	人民网-国际金融报
国际金融报	人民网-国际金融报
英才商业杂志	英才商业杂志
英才	英才商业杂志
日本住友电气工业株式会社	日本住友电气工业株式会社
住友电工	日本住友电气工业株式会社
中国经济导报	中国经济导报
中国经济导报	中国经济导报
北京农村商业银行	北京农村商业银行
北京农村商业银行	北京农村商业银行
北大方正集团有限公司	北大方正集团有限公司
北大方正	北大方正集团有限公司
二滩水电开发有限责任公司	二滩水电开发有限责任公司
二滩水电	二滩水电开发有限责任公司
北京城建投资发展股份有限公司	北京城建投资发展股份有限公司
北京城建	北京城建投资发展股份有限公司
上海凯利泰医疗科技股份有限公司	上海凯利泰医疗科技股份有限公司
凯利泰	上海凯利泰医疗科技股份有限公司
日本神户钢铁公司	日本神户钢铁公司
神户制钢	日本神户钢铁公司
上工申贝(集团)股份有限公司	上工申贝(集团)股份有限公司
上工申贝	上工申贝(集团)股份有限公司
安徽省司尔特肥业股份有限公司	安徽省司尔特肥业股份有限公司
司尔特	安徽省司尔特肥业股份有限公司
山东联合化工股份有限公司	山东联合化工股份有限公司
联合化工	山东联合化工股份有限公司
深圳市中金岭南有色金属股份有限公司	深圳市中金岭南有色金属股份有限公司
中金岭南	深圳市中金岭南有色金属股份有限公司
宁波波导股份有限公司	宁波波导股份有限公司
波导股份	宁波波导股份有限公司
朗姿股份有限公司	朗姿股份有限公司
朗姿股份	朗姿股份有限公司
山东隆基机械股份有限公司	山东隆基机械股份有限公司
隆基机械	山东隆基机械股份有限公司
中绿食品集团有限公司	中绿食品集团有限公司
中绿集团	中绿食品集团有限公司
广州杰赛科技股份有限公司	广州杰赛科技股份有限公司
杰赛科技	广州杰赛科技股份有限公司
中昌海运股份有限公司	中昌海运股份有限公司
中昌海运	中昌海运股份有限公司
huanqiushibao	huanqiushibao
环球时报	huanqiushibao
墨西哥西迈克斯集团	墨西哥西迈克斯集团
西迈克斯	墨西哥西迈克斯集团
华映科技(集团)股份有限公司	华映科技(集团)股份有限公司
华映科技	华映科技(集团)股份有限公司
联合包裹速递服务公司	联合包裹速递服务公司
.*UPS	联合包裹速递服务公司
浙江震元股份有限公司	浙江震元股份有限公司
浙江震元	浙江震元股份有限公司
泰康人寿保险股份有限公司	泰康人寿保险股份有限公司
泰康人寿	泰康人寿保险股份有限公司
林州重机集团股份有限公司	林州重机集团股份有限公司
林州重机	林州重机集团股份有限公司
湖北迈亚股份有限公司	湖北迈亚股份有限公司
\\*ST迈亚	湖北迈亚股份有限公司
福建东南新闻网	福建东南新闻网
东南新闻网	福建东南新闻网
深圳市特发信息股份有限公司	深圳市特发信息股份有限公司
特发信息	深圳市特发信息股份有限公司
露笑科技股份有限公司	露笑科技股份有限公司
露笑科技	露笑科技股份有限公司
中国医药保健品股份有限公司	中国医药保健品股份有限公司
中国医药	中国医药保健品股份有限公司
陕西广电网络传媒(集团)股份有限公司	陕西广电网络传媒(集团)股份有限公司
广电网络	陕西广电网络传媒(集团)股份有限公司
江苏华宏科技股份有限公司	江苏华宏科技股份有限公司
华宏科技	江苏华宏科技股份有限公司
四川东材科技集团股份有限公司	四川东材科技集团股份有限公司
东材科技	四川东材科技集团股份有限公司
上海市北高新股份有限公司	上海市北高新股份有限公司
市北高新	上海市北高新股份有限公司
张家港富瑞特种装备股份有限公司	张家港富瑞特种装备股份有限公司
富瑞特装	张家港富瑞特种装备股份有限公司
哈尔滨高科技(集团)股份有限公司	哈尔滨高科技(集团)股份有限公司
哈高科	哈尔滨高科技(集团)股份有限公司
江苏扬农化工股份有限公司	江苏扬农化工股份有限公司
扬农化工	江苏扬农化工股份有限公司
安徽盛运环保（集团）股份有限公司	安徽盛运环保（集团）股份有限公司
盛运股份	安徽盛运环保（集团）股份有限公司
上海汉钟精机股份有限公司	上海汉钟精机股份有限公司
汉钟精机	上海汉钟精机股份有限公司
陕西宝光真空电器股份有限公司	陕西宝光真空电器股份有限公司
宝光股份	陕西宝光真空电器股份有限公司
浙江核新同花顺网络信息股份有限公司	浙江核新同花顺网络信息股份有限公司
同花顺	浙江核新同花顺网络信息股份有限公司
当代东方投资股份有限公司	当代东方投资股份有限公司
当代东方	当代东方投资股份有限公司
湖南郴电国际发展股份有限公司	湖南郴电国际发展股份有限公司
郴电国际	湖南郴电国际发展股份有限公司
加多宝集团	加多宝集团
加多宝	加多宝集团
西藏雅砻藏药股份有限公司	西藏雅砻藏药股份有限公司
\\*ST雅砻	西藏雅砻藏药股份有限公司
兴业银行股份有限公司	兴业银行股份有限公司
兴业银行	兴业银行股份有限公司
浙江新湖集团股份有限公司	浙江新湖集团股份有限公司
新湖集团	浙江新湖集团股份有限公司
北京华谊兄弟传媒集团	北京华谊兄弟传媒集团
华谊兄弟传媒	北京华谊兄弟传媒集团
大华集团	大华集团
大华集团	大华集团
深圳市燃气集团股份有限公司	深圳市燃气集团股份有限公司
深圳燃气	深圳市燃气集团股份有限公司
上海嘉里粮油工业有限公司	上海嘉里粮油工业有限公司
嘉里粮油	上海嘉里粮油工业有限公司
北京六必居食品有限公司	北京六必居食品有限公司
六必居	北京六必居食品有限公司
安徽精诚铜业股份有限公司	安徽精诚铜业股份有限公司
精诚铜业	安徽精诚铜业股份有限公司
万方城镇投资发展股份有限公司	万方城镇投资发展股份有限公司
万方发展	万方城镇投资发展股份有限公司
广夏(银川)实业股份有限公司	广夏(银川)实业股份有限公司
银广夏.*\\*ST广夏	广夏(银川)实业股份有限公司
浙江阳光集团股份有限公司	浙江阳光集团股份有限公司
浙江阳光	浙江阳光集团股份有限公司
浙江新安化工集团股份有限公司	浙江新安化工集团股份有限公司
新安股份	浙江新安化工集团股份有限公司
牧原食品股份有限公司	牧原食品股份有限公司
牧原股份	牧原食品股份有限公司
葫芦岛锌业股份有限公司	葫芦岛锌业股份有限公司
锌业股份.*\\*ST锌业	葫芦岛锌业股份有限公司
天顺风能（苏州）股份有限公司	天顺风能（苏州）股份有限公司
天顺风能	天顺风能（苏州）股份有限公司
新疆青松建材化工(集团)股份有限公司	新疆青松建材化工(集团)股份有限公司
青松建化	新疆青松建材化工(集团)股份有限公司
新余钢铁股份有限公司	新余钢铁股份有限公司
新钢股份	新余钢铁股份有限公司
舜宇光学科技集团有限公司	舜宇光学科技集团有限公司
舜宇光学	舜宇光学科技集团有限公司
霸王国际（集团）控股有限公司	霸王国际（集团）控股有限公司
霸王国际	霸王国际（集团）控股有限公司
中房置业股份有限公司	中房置业股份有限公司
中房股份.*\\*ST中房	中房置业股份有限公司
珠海世纪鼎利通信科技股份有限公司	珠海世纪鼎利通信科技股份有限公司
世纪鼎利	珠海世纪鼎利通信科技股份有限公司
本钢板材股份有限公司	本钢板材股份有限公司
本钢板材	本钢板材股份有限公司
维维食品饮料股份有限公司	维维食品饮料股份有限公司
维维股份	维维食品饮料股份有限公司
吉林亚泰集团股份有限公司	吉林亚泰集团股份有限公司
亚泰集团	吉林亚泰集团股份有限公司
飞利浦公司	飞利浦公司
飞利浦	飞利浦公司
中欧基金管理有限公司	中欧基金管理有限公司
中欧基金	中欧基金管理有限公司
东莞宏远工业区股份有限公司	东莞宏远工业区股份有限公司
粤宏远.*粤宏远A.*粤宏远Ａ	东莞宏远工业区股份有限公司
冠捷科技集团	冠捷科技集团
冠捷科技	冠捷科技集团
德国宝马汽车公司	德国宝马汽车公司
宝马	德国宝马汽车公司
中国南方航空股份有限公司	中国南方航空股份有限公司
南方航空	中国南方航空股份有限公司
北京北纬通信科技股份有限公司	北京北纬通信科技股份有限公司
北纬通信	北京北纬通信科技股份有限公司
南非啤酒集团	南非啤酒集团
南非啤酒	南非啤酒集团
齐鲁证券有限公司	齐鲁证券有限公司
齐鲁证券	齐鲁证券有限公司
中国石油化工股份有限公司北京燕山分公司	中国石油化工股份有限公司北京燕山分公司
燕山石化	中国石油化工股份有限公司北京燕山分公司
海外海集团有限公司	海外海集团有限公司
海外海集团	海外海集团有限公司
吉林敖东药业集团股份有限公司	吉林敖东药业集团股份有限公司
吉林敖东	吉林敖东药业集团股份有限公司
马来西亚石油公司	马来西亚石油公司
马石油	马来西亚石油公司
百视通新媒体股份有限公司	百视通新媒体股份有限公司
百视通	百视通新媒体股份有限公司
上海新世界股份有限公司	上海新世界股份有限公司
新世界	上海新世界股份有限公司
上海华鑫股份有限公司	上海华鑫股份有限公司
华鑫股份	上海华鑫股份有限公司
暴雪娱乐公司	暴雪娱乐公司
暴雪	暴雪娱乐公司
三联商社股份有限公司	三联商社股份有限公司
三联商社	三联商社股份有限公司
鄂州新闻网	鄂州新闻网
鄂州新闻网	鄂州新闻网
广东塔牌集团股份有限公司	广东塔牌集团股份有限公司
塔牌集团	广东塔牌集团股份有限公司
江南模塑科技股份有限公司	江南模塑科技股份有限公司
模塑科技	江南模塑科技股份有限公司
大连橡胶塑料机械股份有限公司	大连橡胶塑料机械股份有限公司
大橡塑	大连橡胶塑料机械股份有限公司
贵州贵航汽车零部件股份有限公司	贵州贵航汽车零部件股份有限公司
贵航股份	贵州贵航汽车零部件股份有限公司
广东东方精工科技股份有限公司	广东东方精工科技股份有限公司
东方精工	广东东方精工科技股份有限公司
广东德美精细化工股份有限公司	广东德美精细化工股份有限公司
德美化工	广东德美精细化工股份有限公司
香港上海汇丰银行有限公司	香港上海汇丰银行有限公司
汇丰银行	香港上海汇丰银行有限公司
浙江省兴合集团公司	浙江省兴合集团公司
浙江兴合集团	浙江省兴合集团公司
江苏南大光电材料股份有限公司	江苏南大光电材料股份有限公司
南大光电	江苏南大光电材料股份有限公司
法国兴业银行	法国兴业银行
法国兴业银行	法国兴业银行
厦门厦工机械股份有限公司	厦门厦工机械股份有限公司
厦工股份	厦门厦工机械股份有限公司
江苏大港股份有限公司	江苏大港股份有限公司
大港股份	江苏大港股份有限公司
北京首都开发控股（集团）有限公司	北京首都开发控股（集团）有限公司
北京首都开发控股（集团）有限公司	北京首都开发控股（集团）有限公司
大成基金管理有限公司	大成基金管理有限公司
大成基金	大成基金管理有限公司
新疆广汇实业股份有限公司	新疆广汇实业股份有限公司
广汇股份	新疆广汇实业股份有限公司
四川泸天化股份有限公司	四川泸天化股份有限公司
泸天化	四川泸天化股份有限公司
深圳市朗科科技有限公司	深圳市朗科科技有限公司
朗科科技有限公司	深圳市朗科科技有限公司
澳柯玛股份有限公司	澳柯玛股份有限公司
澳柯玛	澳柯玛股份有限公司
中钨高新材料股份有限公司	中钨高新材料股份有限公司
中钨高新.*\\*ST中钨	中钨高新材料股份有限公司
三一重工股份有限公司	三一重工股份有限公司
三一重工	三一重工股份有限公司
大连大杨创世股份有限公司	大连大杨创世股份有限公司
大杨创世	大连大杨创世股份有限公司
好想你枣业股份有限公司	好想你枣业股份有限公司
好想你	好想你枣业股份有限公司
庞大汽贸集团股份有限公司	庞大汽贸集团股份有限公司
庞大集团	庞大汽贸集团股份有限公司
第九城市计算机技术咨询（上海）有限公司	第九城市计算机技术咨询（上海）有限公司
九城	第九城市计算机技术咨询（上海）有限公司
郑州宇通客车股份有限公司	郑州宇通客车股份有限公司
宇通客车	郑州宇通客车股份有限公司
厦门航空有限公司	厦门航空有限公司
厦门航空	厦门航空有限公司
浙江英特集团股份有限公司	浙江英特集团股份有限公司
英特集团	浙江英特集团股份有限公司
北京赛迪传媒投资股份有限公司	北京赛迪传媒投资股份有限公司
赛迪传媒.*\\*ST传媒	北京赛迪传媒投资股份有限公司
玉源控股股份有限公司	玉源控股股份有限公司
ST玉源	玉源控股股份有限公司
四川托普软件投资股份有限公司	四川托普软件投资股份有限公司
托普软件	四川托普软件投资股份有限公司
赤峰富龙热电股份有限公司	赤峰富龙热电股份有限公司
富龙热电	赤峰富龙热电股份有限公司
北京歌华有线电视网络股份有限公司	北京歌华有线电视网络股份有限公司
歌华有线	北京歌华有线电视网络股份有限公司
山西大土河焦化有限责任公司	山西大土河焦化有限责任公司
大土河焦化	山西大土河焦化有限责任公司
佛山佛塑科技集团股份有限公司	佛山佛塑科技集团股份有限公司
佛塑科技	佛山佛塑科技集团股份有限公司
江苏澳洋科技股份有限公司	江苏澳洋科技股份有限公司
澳洋科技	江苏澳洋科技股份有限公司
贵州百灵企业集团制药股份有限公司	贵州百灵企业集团制药股份有限公司
贵州百灵	贵州百灵企业集团制药股份有限公司
浙江仙琚制药股份有限公司	浙江仙琚制药股份有限公司
仙琚制药	浙江仙琚制药股份有限公司
上海安硕信息技术股份有限公司	上海安硕信息技术股份有限公司
安硕信息	上海安硕信息技术股份有限公司
北极光创投	北极光创投
北极光创投	北极光创投
成都国腾电子技术股份有限公司	成都国腾电子技术股份有限公司
国腾电子	成都国腾电子技术股份有限公司
农夫山泉股份有限公司	农夫山泉股份有限公司
农夫山泉	农夫山泉股份有限公司
巨人网络集团有限公司	巨人网络集团有限公司
巨人网络	巨人网络集团有限公司
埃克森美孚公司	埃克森美孚公司
埃克森美孚	埃克森美孚公司
浙江亚太机电股份有限公司	浙江亚太机电股份有限公司
亚太股份.*亚太机电	浙江亚太机电股份有限公司
每日甘肃网	每日甘肃网
每日甘肃网	每日甘肃网
青岛市恒顺电气股份有限公司	青岛市恒顺电气股份有限公司
恒顺电气	青岛市恒顺电气股份有限公司
南风化工集团股份有限公司	南风化工集团股份有限公司
南风化工	南风化工集团股份有限公司
广州达意隆包装机械股份有限公司	广州达意隆包装机械股份有限公司
达意隆	广州达意隆包装机械股份有限公司
宁波均胜电子股份有限公司	宁波均胜电子股份有限公司
均胜电子	宁波均胜电子股份有限公司
五矿稀土股份有限公司	五矿稀土股份有限公司
五矿稀土	五矿稀土股份有限公司
搜狐网	搜狐网
搜狐	搜狐网
北京国电清新环保技术股份有限公司	北京国电清新环保技术股份有限公司
国电清新	北京国电清新环保技术股份有限公司
金发科技股份有限公司	金发科技股份有限公司
金发科技	金发科技股份有限公司
江苏太平洋石英股份有限公司	江苏太平洋石英股份有限公司
石英股份	江苏太平洋石英股份有限公司
花旗集团	花旗集团
花旗银行	花旗集团
东亚银行	东亚银行
东亚银行	东亚银行
中银国际证券有限责任公司	中银国际证券有限责任公司
中银国际证券	中银国际证券有限责任公司
中国南方工业集团公司	中国南方工业集团公司
南方工业	中国南方工业集团公司
中国国旅股份公司	中国国旅股份公司
中国国旅	中国国旅股份公司
宁波宜科科技实业股份有限公司	宁波宜科科技实业股份有限公司
宜科科技	宁波宜科科技实业股份有限公司
山东龙力生物科技股份有限公司	山东龙力生物科技股份有限公司
龙力生物	山东龙力生物科技股份有限公司
荣科科技股份有限公司	荣科科技股份有限公司
荣科科技	荣科科技股份有限公司
农银汇理基金管理有限公司	农银汇理基金管理有限公司
农银汇理基金	农银汇理基金管理有限公司
深圳市怡亚通供应链股份有限公司	深圳市怡亚通供应链股份有限公司
怡亚通	深圳市怡亚通供应链股份有限公司
西屋电气公司	西屋电气公司
西屋电气	西屋电气公司
上海中西药业股份有限公司	上海中西药业股份有限公司
中西药业	上海中西药业股份有限公司
葡萄牙高浦能源公司	葡萄牙高浦能源公司
高浦能源	葡萄牙高浦能源公司
甘肃兰光科技股份有限公司	甘肃兰光科技股份有限公司
S\\*ST兰光	甘肃兰光科技股份有限公司
舜网	舜网
舜网	舜网
恒基兆业地产有限公司	恒基兆业地产有限公司
恒基兆业	恒基兆业地产有限公司
浙江古越龙山绍兴酒股份有限公司	浙江古越龙山绍兴酒股份有限公司
古越龙山	浙江古越龙山绍兴酒股份有限公司
哈尔滨轴承集团公司	哈尔滨轴承集团公司
哈尔滨轴承	哈尔滨轴承集团公司
秦皇岛新闻网	秦皇岛新闻网
秦皇岛新闻网	秦皇岛新闻网
浙江双箭橡胶股份有限公司	浙江双箭橡胶股份有限公司
双箭股份	浙江双箭橡胶股份有限公司
上海柴油机股份有限公司	上海柴油机股份有限公司
上柴股份	上海柴油机股份有限公司
美国洲际交易所	美国洲际交易所
洲际交易所	美国洲际交易所
麦克奥迪(厦门)电气股份有限公司	麦克奥迪(厦门)电气股份有限公司
麦迪电气	麦克奥迪(厦门)电气股份有限公司
徐州燃控科技股份有限公司	徐州燃控科技股份有限公司
燃控科技	徐州燃控科技股份有限公司
新疆金风科技股份有限公司	新疆金风科技股份有限公司
金风科技	新疆金风科技股份有限公司
上海巴安水务股份有限公司	上海巴安水务股份有限公司
巴安水务	上海巴安水务股份有限公司
公益时报	公益时报
公益时报	公益时报
重庆莱美药业股份有限公司	重庆莱美药业股份有限公司
莱美药业	重庆莱美药业股份有限公司
北京荣之联科技股份有限公司	北京荣之联科技股份有限公司
荣之联	北京荣之联科技股份有限公司
江苏爱康科技股份有限公司	江苏爱康科技股份有限公司
爱康科技	江苏爱康科技股份有限公司
江苏凤凰出版传媒股份有限公司	江苏凤凰出版传媒股份有限公司
凤凰传媒	江苏凤凰出版传媒股份有限公司
吉林华微电子股份有限公司	吉林华微电子股份有限公司
华微电子	吉林华微电子股份有限公司
中国宝安集团股份有限公司	中国宝安集团股份有限公司
中国宝安	中国宝安集团股份有限公司
西班牙国际银行	西班牙国际银行
西班牙国际银行	西班牙国际银行
日本航空公司	日本航空公司
日本航空	日本航空公司
安琪酵母股份有限公司	安琪酵母股份有限公司
安琪酵母	安琪酵母股份有限公司
广东金莱特电器股份有限公司	广东金莱特电器股份有限公司
金莱特	广东金莱特电器股份有限公司
大连美罗药业股份有限公司	大连美罗药业股份有限公司
美罗药业	大连美罗药业股份有限公司
湘潭电化科技股份有限公司	湘潭电化科技股份有限公司
湘潭电化	湘潭电化科技股份有限公司
九阳股份有限公司	九阳股份有限公司
九阳股份.*九阳	九阳股份有限公司
山东太阳纸业股份有限公司	山东太阳纸业股份有限公司
太阳纸业	山东太阳纸业股份有限公司
内蒙古君正能源化工股份有限公司	内蒙古君正能源化工股份有限公司
内蒙君正	内蒙古君正能源化工股份有限公司
江苏云意电气股份有限公司	江苏云意电气股份有限公司
云意电气	江苏云意电气股份有限公司
鞍山第一工程机械股份有限公司	鞍山第一工程机械股份有限公司
鞍山一工	鞍山第一工程机械股份有限公司
江苏申龙高科集团股份有限公司	江苏申龙高科集团股份有限公司
\\*ST申龙	江苏申龙高科集团股份有限公司
辉瑞制药有限公司	辉瑞制药有限公司
辉瑞	辉瑞制药有限公司
山西安泰集团股份有限公司	山西安泰集团股份有限公司
安泰集团	山西安泰集团股份有限公司
运盛上海实业股份有限公司	运盛上海实业股份有限公司
运盛实业	运盛上海实业股份有限公司
彩虹显示器件股份有限公司	彩虹显示器件股份有限公司
彩虹股份	彩虹显示器件股份有限公司
襄阳汽车轴承股份有限公司	襄阳汽车轴承股份有限公司
襄阳轴承	襄阳汽车轴承股份有限公司
日出东方太阳能股份有限公司	日出东方太阳能股份有限公司
日出东方	日出东方太阳能股份有限公司
戴姆勒-奔驰公司	戴姆勒-奔驰公司
戴姆勒	戴姆勒-奔驰公司
沈阳合金投资股份有限公司	沈阳合金投资股份有限公司
合金投资.*SST合金	沈阳合金投资股份有限公司
华锐风电科技(集团)股份有限公司	华锐风电科技(集团)股份有限公司
华锐风电	华锐风电科技(集团)股份有限公司
力拓集团	力拓集团
力拓	力拓集团
大庆油田有限责任公司	大庆油田有限责任公司
大庆油田	大庆油田有限责任公司
浙江省天圣控股集团有限公司	浙江省天圣控股集团有限公司
天圣控股	浙江省天圣控股集团有限公司
骏威汽车有限公司	骏威汽车有限公司
骏威汽车	骏威汽车有限公司
贝塔斯曼集团	贝塔斯曼集团
贝塔斯曼	贝塔斯曼集团
北京首放投资顾问有限公司	北京首放投资顾问有限公司
北京首放	北京首放投资顾问有限公司
山东鲁阳股份有限公司	山东鲁阳股份有限公司
鲁阳股份	山东鲁阳股份有限公司
宝鸡商场集团股份有限公司	宝鸡商场集团股份有限公司
宝商集团	宝鸡商场集团股份有限公司
浙江巨化股份有限公司	浙江巨化股份有限公司
巨化股份	浙江巨化股份有限公司
吉林光华控股集团股份有限公司	吉林光华控股集团股份有限公司
光华控股	吉林光华控股集团股份有限公司
泰豪科技股份有限公司	泰豪科技股份有限公司
泰豪科技	泰豪科技股份有限公司
北方联合出版传媒(集团)股份有限公司	北方联合出版传媒(集团)股份有限公司
出版传媒	北方联合出版传媒(集团)股份有限公司
新疆汇通集团股份有限公司	新疆汇通集团股份有限公司
汇通集团	新疆汇通集团股份有限公司
江苏润和软件股份有限公司	江苏润和软件股份有限公司
润和软件	江苏润和软件股份有限公司
上海神奇制药投资管理股份有限公司	上海神奇制药投资管理股份有限公司
神奇制药	上海神奇制药投资管理股份有限公司
北京京运通科技股份有限公司	北京京运通科技股份有限公司
京运通	北京京运通科技股份有限公司
新天国际葡萄酒业股份有限公司	新天国际葡萄酒业股份有限公司
ST新天	新天国际葡萄酒业股份有限公司
苏州新海宜通信科技股份有限公司	苏州新海宜通信科技股份有限公司
新海宜	苏州新海宜通信科技股份有限公司
北京恒华伟业科技股份有限公司	北京恒华伟业科技股份有限公司
恒华科技	北京恒华伟业科技股份有限公司
戴姆勒·克莱斯勒公司	戴姆勒·克莱斯勒公司
克莱斯勒	戴姆勒·克莱斯勒公司
德意志银行股份公司	德意志银行股份公司
德意志银行	德意志银行股份公司
金科地产集团股份有限公司	金科地产集团股份有限公司
金科股份	金科地产集团股份有限公司
江苏新科电子集团有限公司	江苏新科电子集团有限公司
新科	江苏新科电子集团有限公司
甘肃蓝科石化高新装备股份有限公司	甘肃蓝科石化高新装备股份有限公司
蓝科高新	甘肃蓝科石化高新装备股份有限公司
华友世纪通讯有限公司	华友世纪通讯有限公司
华友世纪	华友世纪通讯有限公司
德力西集团	德力西集团
德力西	德力西集团
山东金晶科技股份有限公司	山东金晶科技股份有限公司
金晶科技	山东金晶科技股份有限公司
山西焦煤集团有限责任公司	山西焦煤集团有限责任公司
焦煤集团	山西焦煤集团有限责任公司
天健网	天健网
天健网	天健网
贵州黔源电力股份有限公司	贵州黔源电力股份有限公司
黔源电力	贵州黔源电力股份有限公司
四川大通燃气开发股份有限公司	四川大通燃气开发股份有限公司
大通燃气	四川大通燃气开发股份有限公司
路翔股份有限公司	路翔股份有限公司
路翔股份	路翔股份有限公司
浙江菲达环保科技股份有限公司	浙江菲达环保科技股份有限公司
菲达环保	浙江菲达环保科技股份有限公司
麦趣尔集团股份有限公司	麦趣尔集团股份有限公司
麦趣尔	麦趣尔集团股份有限公司
仁和药业股份有限公司	仁和药业股份有限公司
仁和药业	仁和药业股份有限公司
亚宝药业集团股份有限公司	亚宝药业集团股份有限公司
亚宝药业	亚宝药业集团股份有限公司
达飞集团	达飞集团
达飞集团	达飞集团
山东联盟化工集团有限公司	山东联盟化工集团有限公司
联盟化工	山东联盟化工集团有限公司
成功营销	成功营销
成功营销	成功营销
马鞍山鼎泰稀土新材料股份有限公司	马鞍山鼎泰稀土新材料股份有限公司
鼎泰新材	马鞍山鼎泰稀土新材料股份有限公司
浙江南洋科技股份有限公司	浙江南洋科技股份有限公司
南洋科技	浙江南洋科技股份有限公司
马鞍山钢铁股份有限公司	马鞍山钢铁股份有限公司
马钢股份	马鞍山钢铁股份有限公司
中国南方电网	中国南方电网
中国南方电网	中国南方电网
东南汽车	东南汽车
东南汽车	东南汽车
东莞市搜于特服装股份有限公司	东莞市搜于特服装股份有限公司
搜于特	东莞市搜于特服装股份有限公司
宁夏青龙管业股份有限公司	宁夏青龙管业股份有限公司
青龙管业	宁夏青龙管业股份有限公司
沈阳特种环保设备制造股份有限公司	沈阳特种环保设备制造股份有限公司
环保股份	沈阳特种环保设备制造股份有限公司
江西洪都航空工业股份有限公司	江西洪都航空工业股份有限公司
洪都航空	江西洪都航空工业股份有限公司
台湾积体电路股份有限工司	台湾积体电路股份有限工司
台积电	台湾积体电路股份有限工司
沃达丰集团有限责任公司	沃达丰集团有限责任公司
沃达丰	沃达丰集团有限责任公司
山煤国际能源集团股份有限公司	山煤国际能源集团股份有限公司
山煤国际	山煤国际能源集团股份有限公司
烟台东方电子信息产业股份有限公司	烟台东方电子信息产业股份有限公司
东方电子	烟台东方电子信息产业股份有限公司
浙江海翔药业股份有限公司	浙江海翔药业股份有限公司
海翔药业	浙江海翔药业股份有限公司
东吴证券股份有限公司	东吴证券股份有限公司
东吴证券	东吴证券股份有限公司
江苏三六五网络股份有限公司	江苏三六五网络股份有限公司
三六五网	江苏三六五网络股份有限公司
杜邦公司	杜邦公司
杜邦	杜邦公司
海南椰岛(集团)股份有限公司	海南椰岛(集团)股份有限公司
海南椰岛	海南椰岛(集团)股份有限公司
市场报	市场报
市场报	市场报
遵义钛业	遵义钛业
遵义钛业	遵义钛业
上海新时达电气股份有限公司	上海新时达电气股份有限公司
新时达	上海新时达电气股份有限公司
信息早报	信息早报
信息早报	信息早报
紫光古汉集团股份有限公司	紫光古汉集团股份有限公司
紫光古汉	紫光古汉集团股份有限公司
大连冰山集团有限公司	大连冰山集团有限公司
冰山集团	大连冰山集团有限公司
瑞士瑞信银行简介	瑞士瑞信银行简介
瑞信	瑞士瑞信银行简介
广夏银川实业股份有限公司	广夏银川实业股份有限公司
ST银广夏	广夏银川实业股份有限公司
上海多伦实业股份有限公司	上海多伦实业股份有限公司
多伦股份	上海多伦实业股份有限公司
深圳市通产丽星股份有限公司	深圳市通产丽星股份有限公司
通产丽星	深圳市通产丽星股份有限公司
安徽电视台	安徽电视台
安徽电视台	安徽电视台
哈尔滨博实自动化股份有限公司	哈尔滨博实自动化股份有限公司
博实股份	哈尔滨博实自动化股份有限公司
广东海印集团股份有限公司	广东海印集团股份有限公司
海印股份	广东海印集团股份有限公司
西安联合信息技术股份有限公司	西安联合信息技术股份有限公司
西安联合信息	西安联合信息技术股份有限公司
ABNAMROBank	ABNAMROBank
荷兰银行	ABNAMROBank
北京嘉德典当有限公司	北京嘉德典当有限公司
嘉德典当	北京嘉德典当有限公司
法国威立雅集团	法国威立雅集团
威立雅	法国威立雅集团
山西通宝能源股份有限公司	山西通宝能源股份有限公司
通宝能源	山西通宝能源股份有限公司
天津天药药业股份有限公司	天津天药药业股份有限公司
天药股份	天津天药药业股份有限公司
精伦电子股份有限公司	精伦电子股份有限公司
精伦电子	精伦电子股份有限公司
云南沃森生物技术股份有限公司	云南沃森生物技术股份有限公司
沃森生物	云南沃森生物技术股份有限公司
深圳市广聚能源股份有限公司	深圳市广聚能源股份有限公司
广聚能源	深圳市广聚能源股份有限公司
杭州天目山药业股份有限公司	杭州天目山药业股份有限公司
天目药业	杭州天目山药业股份有限公司
美国劳氏公司	美国劳氏公司
劳氏	美国劳氏公司
新疆中基实业股份有限公司	新疆中基实业股份有限公司
新中基	新疆中基实业股份有限公司
香溢融通控股集团股份有限公司	香溢融通控股集团股份有限公司
香溢融通	香溢融通控股集团股份有限公司
山东鲁证有限公司	山东鲁证有限公司
鲁证期货	山东鲁证有限公司
浙江步森服饰股份有限公司	浙江步森服饰股份有限公司
步森股份	浙江步森服饰股份有限公司
宜宾纸业股份有限公司	宜宾纸业股份有限公司
宜宾纸业.*\\*ST宜纸	宜宾纸业股份有限公司
中天建设集团有限公司	中天建设集团有限公司
中天建设	中天建设集团有限公司
中国远洋控股股份有限公司	中国远洋控股股份有限公司
中国远洋	中国远洋控股股份有限公司
可口可乐公司	可口可乐公司
可口可乐	可口可乐公司
上海广电信息产业股份有限公司	上海广电信息产业股份有限公司
广电信息	上海广电信息产业股份有限公司
吉林永大集团股份有限公司	吉林永大集团股份有限公司
永大集团	吉林永大集团股份有限公司
金业集团	金业集团
金业集团	金业集团
乐视网	乐视网
乐视网	乐视网
深圳市长园集团股份有限公司	深圳市长园集团股份有限公司
长园集团	深圳市长园集团股份有限公司
科林环保装备股份有限公司	科林环保装备股份有限公司
科林环保	科林环保装备股份有限公司
中国亳州网	中国亳州网
中国亳州网	中国亳州网
德国汉高公司	德国汉高公司
汉高	德国汉高公司
量子高科(中国)生物股份有限公司	量子高科(中国)生物股份有限公司
量子高科	量子高科(中国)生物股份有限公司
吉林领先科技发展股份有限公司	吉林领先科技发展股份有限公司
领先科技	吉林领先科技发展股份有限公司
中美天津史克制药有限公司	中美天津史克制药有限公司
中美史克	中美天津史克制药有限公司
宁夏银星能源股份有限公司	宁夏银星能源股份有限公司
银星能源	宁夏银星能源股份有限公司
江苏恒顺醋业股份有限公司	江苏恒顺醋业股份有限公司
恒顺醋业	江苏恒顺醋业股份有限公司
青岛海立美达股份有限公司	青岛海立美达股份有限公司
海立美达	青岛海立美达股份有限公司
人福医药集团股份公司	人福医药集团股份公司
人福医药	人福医药集团股份公司
浙江尖峰集团股份有限公司	浙江尖峰集团股份有限公司
尖峰集团	浙江尖峰集团股份有限公司
南宁糖业股份有限公司	南宁糖业股份有限公司
南宁糖业	南宁糖业股份有限公司
北京联信永益科技股份有限公司	北京联信永益科技股份有限公司
联信永益	北京联信永益科技股份有限公司
劲牌有限公司	劲牌有限公司
劲牌	劲牌有限公司
法国索菲亚（SOGAL）公司	法国索菲亚（SOGAL）公司
索菲亚	法国索菲亚（SOGAL）公司
江苏四方机构集团有限公司	江苏四方机构集团有限公司
四方集团	江苏四方机构集团有限公司
桐昆集团股份有限公司	桐昆集团股份有限公司
桐昆股份	桐昆集团股份有限公司
新太科技股份有限公司	新太科技股份有限公司
S\\*ST新太	新太科技股份有限公司
北京能源投资（集团）有限公司	北京能源投资（集团）有限公司
京能集团	北京能源投资（集团）有限公司
太阳鸟游艇股份有限公司	太阳鸟游艇股份有限公司
太阳鸟	太阳鸟游艇股份有限公司
中国全聚德(集团)股份有限公司	中国全聚德(集团)股份有限公司
全聚德	中国全聚德(集团)股份有限公司
山东航空集团	山东航空集团
山东航空	山东航空集团
东莞劲胜精密组件股份有限公司	东莞劲胜精密组件股份有限公司
劲胜股份	东莞劲胜精密组件股份有限公司
山西美锦能源股份有限公司	山西美锦能源股份有限公司
美锦能源	山西美锦能源股份有限公司
重庆博腾制药科技股份有限公司	重庆博腾制药科技股份有限公司
博腾股份	重庆博腾制药科技股份有限公司
长城汽车股份有限公司	长城汽车股份有限公司
长城汽车	长城汽车股份有限公司
佛山星期六鞋业股份有限公司	佛山星期六鞋业股份有限公司
星期六.*星期六鞋业	佛山星期六鞋业股份有限公司
永隆银行	永隆银行
永隆银行	永隆银行
中新大东方人寿保险有限公司	中新大东方人寿保险有限公司
中新大东方人寿	中新大东方人寿保险有限公司
美克国际家具股份有限公司	美克国际家具股份有限公司
美克股份	美克国际家具股份有限公司
内蒙古蒙牛乳业股份有限公司	内蒙古蒙牛乳业股份有限公司
蒙牛	内蒙古蒙牛乳业股份有限公司
xinhuanet	xinhuanet
新华网	xinhuanet
理财周报	理财周报
理财周报	理财周报
恒生银行	恒生银行
恒生银行	恒生银行
开滦能源化工股份有限公司	开滦能源化工股份有限公司
开滦股份	开滦能源化工股份有限公司
广东宝丽华新能源股份有限公司	广东宝丽华新能源股份有限公司
宝新能源	广东宝丽华新能源股份有限公司
北京当升材料科技股份有限公司	北京当升材料科技股份有限公司
当升科技	北京当升材料科技股份有限公司
新华基金管理有限公司	新华基金管理有限公司
新华基金	新华基金管理有限公司
广汇能源股份有限公司	广汇能源股份有限公司
广汇能源	广汇能源股份有限公司
冠生园集团有限公司	冠生园集团有限公司
冠生园	冠生园集团有限公司
北京东方雨虹防水技术股份有限公司	北京东方雨虹防水技术股份有限公司
东方雨虹	北京东方雨虹防水技术股份有限公司
石家庄以岭药业股份有限公司	石家庄以岭药业股份有限公司
以岭药业	石家庄以岭药业股份有限公司
华泰联合证券股份有限公司	华泰联合证券股份有限公司
华泰联合证券	华泰联合证券股份有限公司
深圳世纪星源股份有限公司	深圳世纪星源股份有限公司
世纪星源	深圳世纪星源股份有限公司
中国北车股份有限公司	中国北车股份有限公司
中国北车.*北车股份	中国北车股份有限公司
东渡国际集团有限公司	东渡国际集团有限公司
东渡国际	东渡国际集团有限公司
浙商基金管理有限公司	浙商基金管理有限公司
浙商基金	浙商基金管理有限公司
山河智能装备股份有限公司	山河智能装备股份有限公司
山河智能	山河智能装备股份有限公司
美都控股股份有限公司	美都控股股份有限公司
美都控股	美都控股股份有限公司
国海证券股份有限公司	国海证券股份有限公司
国海证券	国海证券股份有限公司
杭州锅炉集团有限公司	杭州锅炉集团有限公司
杭州锅炉	杭州锅炉集团有限公司
铁岭新城投资控股股份有限公司	铁岭新城投资控股股份有限公司
铁岭新城	铁岭新城投资控股股份有限公司
山西漳泽电力股份有限公司	山西漳泽电力股份有限公司
漳泽电力	山西漳泽电力股份有限公司
方大炭素新材料科技股份有限公司	方大炭素新材料科技股份有限公司
方大炭素	方大炭素新材料科技股份有限公司
思源电气股份有限公司	思源电气股份有限公司
思源电气	思源电气股份有限公司
江苏吉鑫风能科技股份有限公司	江苏吉鑫风能科技股份有限公司
吉鑫科技	江苏吉鑫风能科技股份有限公司
湖北三丰智能输送装备股份有限公司	湖北三丰智能输送装备股份有限公司
三丰智能	湖北三丰智能输送装备股份有限公司
南通科技投资集团股份有限公司	南通科技投资集团股份有限公司
南通科技	南通科技投资集团股份有限公司
安徽金禾实业股份有限公司	安徽金禾实业股份有限公司
金禾实业	安徽金禾实业股份有限公司
海昌	海昌
海昌	海昌
宁波韵升股份有限公司	宁波韵升股份有限公司
宁波韵升	宁波韵升股份有限公司
杭州新世纪信息技术股份有限公司	杭州新世纪信息技术股份有限公司
新世纪	杭州新世纪信息技术股份有限公司
盛和资源控股股份有限公司	盛和资源控股股份有限公司
盛和资源	盛和资源控股股份有限公司
广东宝莱特医用科技股份有限公司	广东宝莱特医用科技股份有限公司
宝莱特	广东宝莱特医用科技股份有限公司
生命人寿保险股份有限公司	生命人寿保险股份有限公司
生命人寿	生命人寿保险股份有限公司
浙江长城电子科技集团	浙江长城电子科技集团
长城电子科技集团	浙江长城电子科技集团
深圳市金新农饲料股份有限公司	深圳市金新农饲料股份有限公司
金新农	深圳市金新农饲料股份有限公司
国海富兰克林基金管理有限公司	国海富兰克林基金管理有限公司
国海富兰克林	国海富兰克林基金管理有限公司
吉林利源精制股份有限公司	吉林利源精制股份有限公司
利源精制	吉林利源精制股份有限公司
大唐华银电力股份有限公司	大唐华银电力股份有限公司
华银电力	大唐华银电力股份有限公司
九牧王股份有限公司	九牧王股份有限公司
九牧王	九牧王股份有限公司
高新兴科技集团股份有限公司	高新兴科技集团股份有限公司
高新兴	高新兴科技集团股份有限公司
淄博万昌科技股份有限公司	淄博万昌科技股份有限公司
万昌科技	淄博万昌科技股份有限公司
湖南科力远新能源股份有限公司	湖南科力远新能源股份有限公司
科力远	湖南科力远新能源股份有限公司
杭州前进齿轮箱集团有限公司	杭州前进齿轮箱集团有限公司
前进齿轮	杭州前进齿轮箱集团有限公司
江苏索普化工股份有限公司	江苏索普化工股份有限公司
江苏索普	江苏索普化工股份有限公司
台湾塑料工业股份有限公司	台湾塑料工业股份有限公司
台塑	台湾塑料工业股份有限公司
河南双汇投资发展股份有限公司	河南双汇投资发展股份有限公司
双汇发展	河南双汇投资发展股份有限公司
北京铜牛集团有限公司	北京铜牛集团有限公司
铜牛集团	北京铜牛集团有限公司
MEADJOHNSON	MEADJOHNSON
美赞臣	MEADJOHNSON
北京数字政通科技股份有限公司	北京数字政通科技股份有限公司
数字政通	北京数字政通科技股份有限公司
四川长虹电器股份有限公司	四川长虹电器股份有限公司
四川长虹	四川长虹电器股份有限公司
江苏开元股份有限公司	江苏开元股份有限公司
江苏开元	江苏开元股份有限公司
广州白云国际机场股份有限公司	广州白云国际机场股份有限公司
白云机场	广州白云国际机场股份有限公司
江苏沙钢集团淮钢特钢有限公司	江苏沙钢集团淮钢特钢有限公司
淮钢特钢	江苏沙钢集团淮钢特钢有限公司
浙江向日葵光能科技股份有限公司	浙江向日葵光能科技股份有限公司
向日葵	浙江向日葵光能科技股份有限公司
中国国际贸易中心股份有限公司	中国国际贸易中心股份有限公司
中国国贸	中国国际贸易中心股份有限公司
新疆天山毛纺织股份有限公司	新疆天山毛纺织股份有限公司
天山纺织	新疆天山毛纺织股份有限公司
中海集装箱运输股份有限公司	中海集装箱运输股份有限公司
中海集运	中海集装箱运输股份有限公司
宁波康强电子股份有限公司	宁波康强电子股份有限公司
康强电子	宁波康强电子股份有限公司
wenhuibao	wenhuibao
文汇报	wenhuibao
xinminwanbao	xinminwanbao
新民晚报	xinminwanbao
海马投资集团股份有限公司	海马投资集团股份有限公司
海马股份	海马投资集团股份有限公司
Verizon通讯公司	Verizon通讯公司
弗莱森通讯	Verizon通讯公司
四川科伦药业股份有限公司	四川科伦药业股份有限公司
科伦药业	四川科伦药业股份有限公司
中文天地出版传媒股份有限公司	中文天地出版传媒股份有限公司
中文传媒	中文天地出版传媒股份有限公司
浙江永通染织集团有限公司	浙江永通染织集团有限公司
永通染织	浙江永通染织集团有限公司
北矿磁材科技股份有限公司	北矿磁材科技股份有限公司
北矿磁材	北矿磁材科技股份有限公司
天津钢铁有限公司	天津钢铁有限公司
天津钢铁	天津钢铁有限公司
天津中环半导体股份有限公司	天津中环半导体股份有限公司
中环股份	天津中环半导体股份有限公司
宁夏大元化工股份有限公司	宁夏大元化工股份有限公司
大元股份	宁夏大元化工股份有限公司
炬力集成电路设计有限公司	炬力集成电路设计有限公司
炬力	炬力集成电路设计有限公司
景顺长城基金管理有限公司	景顺长城基金管理有限公司
景顺长城.*景顺长城基金	景顺长城基金管理有限公司
申能股份有限公司	申能股份有限公司
申能股份	申能股份有限公司
岳阳林纸股份有限公司	岳阳林纸股份有限公司
岳阳林纸	岳阳林纸股份有限公司
国海证券有限责任公司	国海证券有限责任公司
国海证券	国海证券有限责任公司
厦门法拉电子股份有限公司	厦门法拉电子股份有限公司
法拉电子	厦门法拉电子股份有限公司
TOM在线	TOM在线
TOM在线	TOM在线
伊仕利壁柜（中国）定制连锁机构	伊仕利壁柜（中国）定制连锁机构
伊仕利	伊仕利壁柜（中国）定制连锁机构
优搜网	优搜网
优搜网	优搜网
鞍山森远路桥股份有限公司	鞍山森远路桥股份有限公司
森远股份	鞍山森远路桥股份有限公司
天津国恒铁路控股股份有限公司	天津国恒铁路控股股份有限公司
国恒铁路.*\\*ST国恒	天津国恒铁路控股股份有限公司
海通证券股份有限公司	海通证券股份有限公司
海通证券	海通证券股份有限公司
北京掌趣科技股份有限公司	北京掌趣科技股份有限公司
掌趣科技	北京掌趣科技股份有限公司
浙江华策影视股份有限公司	浙江华策影视股份有限公司
华策影视	浙江华策影视股份有限公司
广东新会美达锦纶股份有限公司	广东新会美达锦纶股份有限公司
美达股份	广东新会美达锦纶股份有限公司
杭州富通通信技术股份有限公司	杭州富通通信技术股份有限公司
富通股份	杭州富通通信技术股份有限公司
西部矿业股份有限公司	西部矿业股份有限公司
西部矿业	西部矿业股份有限公司
上海水仙电器股份有限公司	上海水仙电器股份有限公司
水仙电器	上海水仙电器股份有限公司
永清环保股份有限公司	永清环保股份有限公司
永清环保	永清环保股份有限公司
杭州老板电器股份有限公司	杭州老板电器股份有限公司
老板电器	杭州老板电器股份有限公司
上海新南洋股份有限公司	上海新南洋股份有限公司
新南洋	上海新南洋股份有限公司
中油龙昌股份有限公司	中油龙昌股份有限公司
石油龙昌	中油龙昌股份有限公司
中华电信股份有限公司	中华电信股份有限公司
中华电信	中华电信股份有限公司
河北福成五丰食品股份有限公司	河北福成五丰食品股份有限公司
福成五丰	河北福成五丰食品股份有限公司
统一企业	统一企业
统一企业	统一企业
中创投资集团有限公司	中创投资集团有限公司
中创投资	中创投资集团有限公司
马应龙药业集团股份有限公司	马应龙药业集团股份有限公司
马应龙	马应龙药业集团股份有限公司
中国证券报	中国证券报
中国证券报	中国证券报
湖南天润实业控股股份有限公司	湖南天润实业控股股份有限公司
天润控股	湖南天润实业控股股份有限公司
飞鹤乳业公司	飞鹤乳业公司
飞鹤乳业公司	飞鹤乳业公司
浙江星星瑞金科技股份有限公司	浙江星星瑞金科技股份有限公司
星星科技	浙江星星瑞金科技股份有限公司
西安高科集团新西部实业发展公司	西安高科集团新西部实业发展公司
西安高科	西安高科集团新西部实业发展公司
中外运空运发展股份有限公司	中外运空运发展股份有限公司
外运发展	中外运空运发展股份有限公司
国际旅游联盟	国际旅游联盟
国际旅游联盟	国际旅游联盟
北京百付宝科技有限公司	北京百付宝科技有限公司
百付宝	北京百付宝科技有限公司
东北电气发展股份有限公司	东北电气发展股份有限公司
东北电气.*\\*ST东电	东北电气发展股份有限公司
龙建路桥股份有限公司	龙建路桥股份有限公司
龙建股份	龙建路桥股份有限公司
岳阳纸业股份有限公司	岳阳纸业股份有限公司
岳阳纸业	岳阳纸业股份有限公司
浙江国际嘉业房地产开发有限公司	浙江国际嘉业房地产开发有限公司
嘉业房产	浙江国际嘉业房地产开发有限公司
汉庭酒店集团	汉庭酒店集团
汉庭酒店集团	汉庭酒店集团
青海盐湖工业集团股份有限公司	青海盐湖工业集团股份有限公司
盐湖集团	青海盐湖工业集团股份有限公司
濮阳濮耐高温材料（集团）股份有限公司	濮阳濮耐高温材料（集团）股份有限公司
濮耐股份	濮阳濮耐高温材料（集团）股份有限公司
深圳中华自行车(集团)股份有限公司	深圳中华自行车(集团)股份有限公司
深中华.*\\*ST中华A	深圳中华自行车(集团)股份有限公司
福建省三钢集团有限责任公司	福建省三钢集团有限责任公司
三钢集团	福建省三钢集团有限责任公司
SOHO中国有限公司	SOHO中国有限公司
SOHO中国	SOHO中国有限公司
上海大江集团股份有限公司	上海大江集团股份有限公司
大江股份	上海大江集团股份有限公司
海南正和实业集团股份有限公司	海南正和实业集团股份有限公司
正和股份	海南正和实业集团股份有限公司
广东奥马电器股份有限公司	广东奥马电器股份有限公司
奥马电器	广东奥马电器股份有限公司
厦门灿坤实业股份有限公司	厦门灿坤实业股份有限公司
闽灿坤.*闽灿坤Ｂ	厦门灿坤实业股份有限公司
盛屯矿业集团股份有限公司	盛屯矿业集团股份有限公司
盛屯矿业	盛屯矿业集团股份有限公司
广东榕泰实业股份有限公司	广东榕泰实业股份有限公司
广东榕泰	广东榕泰实业股份有限公司
大连易世达新能源发展股份有限公司	大连易世达新能源发展股份有限公司
易世达	大连易世达新能源发展股份有限公司
浪潮软件股份有限公司	浪潮软件股份有限公司
浪潮软件	浪潮软件股份有限公司
北京完美时空网络技术有限公司	北京完美时空网络技术有限公司
完美时空	北京完美时空网络技术有限公司
东方国际创业股份有限公司	东方国际创业股份有限公司
东方创业	东方国际创业股份有限公司
中国商人	中国商人
中国商人	中国商人
凯撒（中国）股份有限公司	凯撒（中国）股份有限公司
凯撒股份	凯撒（中国）股份有限公司
华立仪表集团有限公司	华立仪表集团有限公司
华立仪表	华立仪表集团有限公司
上海三毛企业集团股份有限公司	上海三毛企业集团股份有限公司
上海三毛	上海三毛企业集团股份有限公司
广东南洋电缆集团股份有限公司	广东南洋电缆集团股份有限公司
南洋股份	广东南洋电缆集团股份有限公司
保龄宝生物股份有限公司	保龄宝生物股份有限公司
保龄宝	保龄宝生物股份有限公司
重庆水务集团股份有限公司	重庆水务集团股份有限公司
重庆水务	重庆水务集团股份有限公司
英国保诚集团简介	英国保诚集团简介
保诚	英国保诚集团简介
宁波新海电气股份有限公司	宁波新海电气股份有限公司
新海股份	宁波新海电气股份有限公司
汕头东风印刷股份有限公司	汕头东风印刷股份有限公司
东风股份	汕头东风印刷股份有限公司
中国随州网	中国随州网
中国随州网	中国随州网
国投瑞银基金管理有限公司	国投瑞银基金管理有限公司
国投瑞银	国投瑞银基金管理有限公司
中金黄金股份有限公司	中金黄金股份有限公司
中金黄金	中金黄金股份有限公司
深圳市铁汉生态环境股份有限公司	深圳市铁汉生态环境股份有限公司
铁汉生态	深圳市铁汉生态环境股份有限公司
华夏基金管理有限公司	华夏基金管理有限公司
华夏基金	华夏基金管理有限公司
重庆太极实业(集团)股份有限公司	重庆太极实业(集团)股份有限公司
太极集团	重庆太极实业(集团)股份有限公司
companyname	companyname
chinesename	companyname
国投新集能源股份有限公司	国投新集能源股份有限公司
国投新集	国投新集能源股份有限公司
百事公司	百事公司
百事	百事公司
香港旭日集团	香港旭日集团
旭日集团	香港旭日集团
银瑞达创业投资有限公司	银瑞达创业投资有限公司
银瑞达	银瑞达创业投资有限公司
Johnson	Johnson
强生	Johnson
北京银信长远科技股份有限公司	北京银信长远科技股份有限公司
银信科技	北京银信长远科技股份有限公司
南方泵业股份有限公司	南方泵业股份有限公司
南方泵业	南方泵业股份有限公司
怀化新闻网	怀化新闻网
怀化新闻网	怀化新闻网
美国礼来公司	美国礼来公司
礼来	美国礼来公司
江苏林洋电子有限公司	江苏林洋电子有限公司
林洋电子	江苏林洋电子有限公司
山东同大海岛新材料股份有限公司	山东同大海岛新材料股份有限公司
同大股份.*同大海岛	山东同大海岛新材料股份有限公司
宁波海运股份有限公司	宁波海运股份有限公司
宁波海运	宁波海运股份有限公司
经济导报	经济导报
经济导报	经济导报
唐人神集团股份有限公司	唐人神集团股份有限公司
唐人神	唐人神集团股份有限公司
浙江江山化工股份有限公司	浙江江山化工股份有限公司
江山化工	浙江江山化工股份有限公司
中国西部网	中国西部网
中国西部网	中国西部网
中宏人寿保险有限公司	中宏人寿保险有限公司
中宏人寿	中宏人寿保险有限公司
深圳市赛格达声股份有限公司	深圳市赛格达声股份有限公司
ST达声	深圳市赛格达声股份有限公司
京投银泰股份有限公司	京投银泰股份有限公司
京投银泰	京投银泰股份有限公司
港中旅华贸国际物流股份有限公司	港中旅华贸国际物流股份有限公司
华贸物流	港中旅华贸国际物流股份有限公司
金河生物科技股份有限公司	金河生物科技股份有限公司
金河生物	金河生物科技股份有限公司
湖北武昌鱼股份有限公司	湖北武昌鱼股份有限公司
武昌鱼.*\\*ST昌鱼	湖北武昌鱼股份有限公司
北京万东医疗装备股份有限公司	北京万东医疗装备股份有限公司
万东医疗	北京万东医疗装备股份有限公司
深圳市飞亚达集团股份有限公司	深圳市飞亚达集团股份有限公司
飞亚达A	深圳市飞亚达集团股份有限公司
苏州胜利精密制造科技股份有限公司	苏州胜利精密制造科技股份有限公司
胜利精密	苏州胜利精密制造科技股份有限公司
华平信息技术股份有限公司	华平信息技术股份有限公司
华平股份	华平信息技术股份有限公司
中国交通报	中国交通报
中国交通报	中国交通报
贵州力源液压股份有限公司	贵州力源液压股份有限公司
力源液压	贵州力源液压股份有限公司
内蒙古鄂尔多斯资源股份有限公司	内蒙古鄂尔多斯资源股份有限公司
鄂尔多斯	内蒙古鄂尔多斯资源股份有限公司
大同煤业股份有限公司	大同煤业股份有限公司
大同煤业	大同煤业股份有限公司
河北新金钢铁有限公司	河北新金钢铁有限公司
新金钢铁	河北新金钢铁有限公司
天津经纬电材股份有限公司	天津经纬电材股份有限公司
经纬电材	天津经纬电材股份有限公司
中电投远达环保(集团)股份有限公司	中电投远达环保(集团)股份有限公司
中电远达	中电投远达环保(集团)股份有限公司
山东省中鲁远洋渔业股份有限公司	山东省中鲁远洋渔业股份有限公司
中鲁远洋.*中鲁Ｂ	山东省中鲁远洋渔业股份有限公司
江苏长电科技股份有限公司	江苏长电科技股份有限公司
长电科技	江苏长电科技股份有限公司
甘肃大禹节水集团股份有限公司	甘肃大禹节水集团股份有限公司
大禹节水	甘肃大禹节水集团股份有限公司
云南铝业股份有限公司	云南铝业股份有限公司
云铝股份	云南铝业股份有限公司
新世纪周刊	新世纪周刊
新世纪周刊	新世纪周刊
35互联	35互联
35互联	35互联
浙江在线	浙江在线
浙江在线	浙江在线
天安保险股份有限公司	天安保险股份有限公司
天安保险	天安保险股份有限公司
青岛明月海藻集团有限公司	青岛明月海藻集团有限公司
明月集团	青岛明月海藻集团有限公司
江阴兴澄特种钢铁公司	江阴兴澄特种钢铁公司
兴澄特钢	江阴兴澄特种钢铁公司
德国弗朗茨海涅尔集团	德国弗朗茨海涅尔集团
哈尼尔集团	德国弗朗茨海涅尔集团
西铁城钟表公司	西铁城钟表公司
西铁城	西铁城钟表公司
美国HCA公司	美国HCA公司
HCA	美国HCA公司
北京高盟新材料股份有限公司	北京高盟新材料股份有限公司
高盟新材	北京高盟新材料股份有限公司
深圳广播电影电视集团	深圳广播电影电视集团
深圳广电	深圳广播电影电视集团
山东得利斯食品股份有限公司	山东得利斯食品股份有限公司
得利斯	山东得利斯食品股份有限公司
广东金马旅游集团股份有限公司	广东金马旅游集团股份有限公司
金马集团	广东金马旅游集团股份有限公司
恒和珠宝集团有限公司	恒和珠宝集团有限公司
恒和集团	恒和珠宝集团有限公司
许继电气股份有限公司	许继电气股份有限公司
许继电气	许继电气股份有限公司
华夏幸福基业股份有限公司	华夏幸福基业股份有限公司
华夏幸福	华夏幸福基业股份有限公司
贵阳朗玛信息技术股份有限公司	贵阳朗玛信息技术股份有限公司
朗玛信息	贵阳朗玛信息技术股份有限公司
阿克苏诺贝尔	阿克苏诺贝尔
阿克苏诺贝尔	阿克苏诺贝尔
南京化纤股份有限公司	南京化纤股份有限公司
南京化纤	南京化纤股份有限公司
江苏宏图高科技股份有限公司	江苏宏图高科技股份有限公司
宏图高科	江苏宏图高科技股份有限公司
浙江升华拜克生物股份有限公司	浙江升华拜克生物股份有限公司
升华拜克	浙江升华拜克生物股份有限公司
陕西法士特汽车传动集团有限责任公司	陕西法士特汽车传动集团有限责任公司
法士特	陕西法士特汽车传动集团有限责任公司
锦州新华龙钼业股份有限公司	锦州新华龙钼业股份有限公司
新华龙	锦州新华龙钼业股份有限公司
青岛汉缆股份有限公司	青岛汉缆股份有限公司
汉缆股份	青岛汉缆股份有限公司
东信和平科技股份有限公司	东信和平科技股份有限公司
东信和平	东信和平科技股份有限公司
贵州国创能源控股(集团)股份有限公司	贵州国创能源控股(集团)股份有限公司
国创能源	贵州国创能源控股(集团)股份有限公司
浙江盾安人工环境设备股份有限公司	浙江盾安人工环境设备股份有限公司
盾安环境	浙江盾安人工环境设备股份有限公司
天津市房地产发展（集团）股份有限公司	天津市房地产发展（集团）股份有限公司
天房发展	天津市房地产发展（集团）股份有限公司
天津赛象科技股份有限公司	天津赛象科技股份有限公司
赛象科技	天津赛象科技股份有限公司
西安交大博通资讯股份有限公司	西安交大博通资讯股份有限公司
博通股份.*交大博通	西安交大博通资讯股份有限公司
福建闽东电力股份有限公司	福建闽东电力股份有限公司
闽东电力	福建闽东电力股份有限公司
航天信息股份有限公司	航天信息股份有限公司
航天信息	航天信息股份有限公司
江苏神通阀门股份有限公司	江苏神通阀门股份有限公司
江苏神通	江苏神通阀门股份有限公司
中钢集团吉林炭素股份有限公司	中钢集团吉林炭素股份有限公司
中钢吉炭	中钢集团吉林炭素股份有限公司
恒泰艾普石油天然气技术服务股份有限公司	恒泰艾普石油天然气技术服务股份有限公司
恒泰艾普	恒泰艾普石油天然气技术服务股份有限公司
杭州前进齿轮箱集团股份有限公司	杭州前进齿轮箱集团股份有限公司
杭齿前进	杭州前进齿轮箱集团股份有限公司
哈尔滨铁路局	哈尔滨铁路局
哈尔滨铁路局	哈尔滨铁路局
甘肃大禹节水股份有限公司	甘肃大禹节水股份有限公司
大禹节水	甘肃大禹节水股份有限公司
中原环保股份有限公司	中原环保股份有限公司
中原环保	中原环保股份有限公司
甘肃电投能源发展股份有限公司	甘肃电投能源发展股份有限公司
甘肃电投	甘肃电投能源发展股份有限公司
山西焦化股份有限公司	山西焦化股份有限公司
山西焦化	山西焦化股份有限公司
苏州晶方半导体科技股份有限公司	苏州晶方半导体科技股份有限公司
晶方科技	苏州晶方半导体科技股份有限公司
中国颐通集团	中国颐通集团
中国颐通	中国颐通集团
中国中材国际工程股份有限公司	中国中材国际工程股份有限公司
中材国际	中国中材国际工程股份有限公司
山东金泰集团股份有限公司	山东金泰集团股份有限公司
山东金泰.*ST金泰	山东金泰集团股份有限公司
兰州黄河企业股份有限公司	兰州黄河企业股份有限公司
兰州黄河	兰州黄河企业股份有限公司
新天科技股份有限公司	新天科技股份有限公司
新天科技	新天科技股份有限公司
福建省青山纸业股份有限公司	福建省青山纸业股份有限公司
青山纸业	福建省青山纸业股份有限公司
江西赛维LDK太阳能高科技有限公司	江西赛维LDK太阳能高科技有限公司
江西赛维	江西赛维LDK太阳能高科技有限公司
深圳市证通电子股份有限公司	深圳市证通电子股份有限公司
证通电子	深圳市证通电子股份有限公司
天津天铁冶金集团有限公司	天津天铁冶金集团有限公司
天铁冶金	天津天铁冶金集团有限公司
上海摩恩电气股份有限公司	上海摩恩电气股份有限公司
摩恩电气	上海摩恩电气股份有限公司
中信证券股份有限公司	中信证券股份有限公司
中信证券	中信证券股份有限公司
安赛乐米塔尔集团	安赛乐米塔尔集团
安赛乐米塔尔	安赛乐米塔尔集团
深圳市物业发展集团股份有限公司	深圳市物业发展集团股份有限公司
S\\*ST物业	深圳市物业发展集团股份有限公司
宝鼎重工股份有限公司	宝鼎重工股份有限公司
宝鼎重工	宝鼎重工股份有限公司
山东威达机械股份有限公司	山东威达机械股份有限公司
山东威达	山东威达机械股份有限公司
南京中央商场股份有限公司	南京中央商场股份有限公司
南京中商	南京中央商场股份有限公司
广东海大集团股份有限公司	广东海大集团股份有限公司
海大集团	广东海大集团股份有限公司
大众交通(集团)股份有限公司	大众交通(集团)股份有限公司
大众交通	大众交通(集团)股份有限公司
华电能源股份有限公司	华电能源股份有限公司
华电能源	华电能源股份有限公司
华润锦华股份有限公司	华润锦华股份有限公司
华润锦华	华润锦华股份有限公司
北京首商集团股份有限公司	北京首商集团股份有限公司
首商股份	北京首商集团股份有限公司
内蒙古包钢钢联股份有限公司	内蒙古包钢钢联股份有限公司
包钢股份	内蒙古包钢钢联股份有限公司
新快报	新快报
新快报	新快报
国药集团药业股份有限公司	国药集团药业股份有限公司
国药股份.*国药集团	国药集团药业股份有限公司
格力地产股份有限公司	格力地产股份有限公司
格力地产	格力地产股份有限公司
美国沃尔格林公司	美国沃尔格林公司
沃尔格林	美国沃尔格林公司
人人乐连锁商业集团股份有限公司	人人乐连锁商业集团股份有限公司
人人乐	人人乐连锁商业集团股份有限公司
兰州民百(集团)股份有限公司	兰州民百(集团)股份有限公司
兰州民百	兰州民百(集团)股份有限公司
中顺汽车控股有限公司	中顺汽车控股有限公司
中顺汽车	中顺汽车控股有限公司
浙江美大实业股份有限公司	浙江美大实业股份有限公司
浙江美大	浙江美大实业股份有限公司
城市快报	城市快报
城市快报	城市快报
金鹰基金管理有限公司	金鹰基金管理有限公司
金鹰基金	金鹰基金管理有限公司
上海神开石油化工装备股份有限公司	上海神开石油化工装备股份有限公司
神开股份	上海神开石油化工装备股份有限公司
易食集团股份有限公司	易食集团股份有限公司
易食股份	易食集团股份有限公司
UT斯达康	UT斯达康
UT斯达康	UT斯达康
内蒙古小肥羊餐饮连锁有限公司	内蒙古小肥羊餐饮连锁有限公司
小肥羊	内蒙古小肥羊餐饮连锁有限公司
上海二纺机股份有限公司	上海二纺机股份有限公司
\\*ST二纺	上海二纺机股份有限公司
xinjingbao	xinjingbao
新京报	xinjingbao
福建省闽发铝业股份有限公司	福建省闽发铝业股份有限公司
闽发铝业	福建省闽发铝业股份有限公司
上海锦江国际酒店发展股份有限公司	上海锦江国际酒店发展股份有限公司
锦江股份	上海锦江国际酒店发展股份有限公司
深圳市英唐智能控制股份有限公司	深圳市英唐智能控制股份有限公司
英唐智控	深圳市英唐智能控制股份有限公司
天津海泰科技发展股份有限公司	天津海泰科技发展股份有限公司
海泰发展	天津海泰科技发展股份有限公司
江苏中联电气股份有限公司	江苏中联电气股份有限公司
中联电气	江苏中联电气股份有限公司
烟台龙源电力技术股份有限公司	烟台龙源电力技术股份有限公司
龙源技术	烟台龙源电力技术股份有限公司
日照港股份有限公司	日照港股份有限公司
日照港	日照港股份有限公司
内蒙古平庄能源股份有限公司	内蒙古平庄能源股份有限公司
平庄能源	内蒙古平庄能源股份有限公司
阳光保险集团股份有限公司	阳光保险集团股份有限公司
阳光保险	阳光保险集团股份有限公司
上海神工环保股份有限公司	上海神工环保股份有限公司
神工环保	上海神工环保股份有限公司
中航三星人寿保险有限公司	中航三星人寿保险有限公司
中航三星人寿	中航三星人寿保险有限公司
浙江贝因美科工贸股份有限公司	浙江贝因美科工贸股份有限公司
贝因美	浙江贝因美科工贸股份有限公司
湖南海利化工股份有限公司	湖南海利化工股份有限公司
湖南海利	湖南海利化工股份有限公司
浙江康恩贝制药股份有限公司	浙江康恩贝制药股份有限公司
康恩贝	浙江康恩贝制药股份有限公司
上海银行	上海银行
上海银行	上海银行
上海开开实业股份有限公司	上海开开实业股份有限公司
开开实业	上海开开实业股份有限公司
中原证券股份有限公司	中原证券股份有限公司
中原证券	中原证券股份有限公司
成都华泽钴镍材料股份有限公司	成都华泽钴镍材料股份有限公司
华泽钴镍	成都华泽钴镍材料股份有限公司
广电日生人寿保险有限公司	广电日生人寿保险有限公司
广电日生人寿	广电日生人寿保险有限公司
福建省福抗药业股份有限公司	福建省福抗药业股份有限公司
福抗药业	福建省福抗药业股份有限公司
天广消防股份有限公司	天广消防股份有限公司
天广消防	天广消防股份有限公司
上海仪电电子股份有限公司	上海仪电电子股份有限公司
仪电电子	上海仪电电子股份有限公司
中国石油化工股份有限公司	中国石油化工股份有限公司
中国石化	中国石油化工股份有限公司
长春一东离合器股份有限公司	长春一东离合器股份有限公司
长春一东	长春一东离合器股份有限公司
广州发展集团股份有限公司	广州发展集团股份有限公司
广州发展	广州发展集团股份有限公司
上海兰生股份有限公司	上海兰生股份有限公司
兰生股份	上海兰生股份有限公司
吴江市恒达城建开发有限公司	吴江市恒达城建开发有限公司
恒达城建	吴江市恒达城建开发有限公司
商界评论	商界评论
商界评论	商界评论
深圳经济特区房地产(集团)股份有限公司	深圳经济特区房地产(集团)股份有限公司
深房集团.*深深房Ａ	深圳经济特区房地产(集团)股份有限公司
海南天然橡胶产业集团股份有限公司	海南天然橡胶产业集团股份有限公司
海南橡胶	海南天然橡胶产业集团股份有限公司
精华制药集团股份有限公司	精华制药集团股份有限公司
精华制药	精华制药集团股份有限公司
宁波热电股份有限公司	宁波热电股份有限公司
宁波热电	宁波热电股份有限公司
上海实业控股有限公司	上海实业控股有限公司
上海实业控股	上海实业控股有限公司
哈尔滨哈投投资股份有限公司	哈尔滨哈投投资股份有限公司
哈投股份	哈尔滨哈投投资股份有限公司
河北钢铁集团	河北钢铁集团
河北钢铁	河北钢铁集团
宁波华翔电子股份有限公司	宁波华翔电子股份有限公司
宁波华翔	宁波华翔电子股份有限公司
南京红太阳股份有限公司	南京红太阳股份有限公司
红太阳	南京红太阳股份有限公司
万方投资控股集团	万方投资控股集团
万方地产	万方投资控股集团
武汉南国置业股份有限公司	武汉南国置业股份有限公司
南国置业	武汉南国置业股份有限公司
大连冷冻机股份有限公司	大连冷冻机股份有限公司
大冷股份	大连冷冻机股份有限公司
内蒙古时代科技股份有限公司	内蒙古时代科技股份有限公司
时代科技	内蒙古时代科技股份有限公司
广州汽车集团股份有限公司	广州汽车集团股份有限公司
广汽集团	广州汽车集团股份有限公司
时代地产控股有限公司	时代地产控股有限公司
时代地产	时代地产控股有限公司
美国好市多公司	美国好市多公司
好市多	美国好市多公司
红牛国际集团	红牛国际集团
红牛集团	红牛国际集团
qianjiangwanbao	qianjiangwanbao
钱江晚报	qianjiangwanbao
苏州斯莱克精密设备股份有限公司	苏州斯莱克精密设备股份有限公司
斯莱克	苏州斯莱克精密设备股份有限公司
福建七匹狼实业股份有限公司	福建七匹狼实业股份有限公司
七匹狼	福建七匹狼实业股份有限公司
深圳市新亚电子制程股份有限公司	深圳市新亚电子制程股份有限公司
新亚制程	深圳市新亚电子制程股份有限公司
中核苏阀科技实业股份有限公司	中核苏阀科技实业股份有限公司
中核科技	中核苏阀科技实业股份有限公司
中国石化扬子石油化工股份有限公司	中国石化扬子石油化工股份有限公司
扬子石化	中国石化扬子石油化工股份有限公司
西藏天路股份有限公司	西藏天路股份有限公司
西藏天路	西藏天路股份有限公司
北京怀建集团有限公司	北京怀建集团有限公司
怀建集团	北京怀建集团有限公司
孚日集团股份有限公司	孚日集团股份有限公司
孚日股份	孚日集团股份有限公司
海能达通信股份有限公司	海能达通信股份有限公司
海能达	海能达通信股份有限公司
河北宣化工程机械股份有限公司	河北宣化工程机械股份有限公司
河北宣工	河北宣化工程机械股份有限公司
百大集团股份有限公司	百大集团股份有限公司
百大集团	百大集团股份有限公司
国家开发投资公司	国家开发投资公司
国家开发投资公司	国家开发投资公司
江苏维尔利环保科技股份有限公司	江苏维尔利环保科技股份有限公司
维尔利	江苏维尔利环保科技股份有限公司
许昌远东传动轴股份有限公司	许昌远东传动轴股份有限公司
远东传动	许昌远东传动轴股份有限公司
东江环保股份有限公司	东江环保股份有限公司
东江环保	东江环保股份有限公司
湖南水口山有色金属集团有限公司	湖南水口山有色金属集团有限公司
水口山集团	湖南水口山有色金属集团有限公司
衢州新闻网	衢州新闻网
衢州新闻网	衢州新闻网
美国固特异轮胎橡胶公司	美国固特异轮胎橡胶公司
固特异	美国固特异轮胎橡胶公司
吉林森林工业股份有限公司	吉林森林工业股份有限公司
吉林森工	吉林森林工业股份有限公司
烟台首钢东星集团公司	烟台首钢东星集团公司
烟台首钢东星	烟台首钢东星集团公司
北京中科三环高技术股份有限公司	北京中科三环高技术股份有限公司
中科三环	北京中科三环高技术股份有限公司
宁夏银行	宁夏银行
宁夏银行	宁夏银行
金叶珠宝股份有限公司	金叶珠宝股份有限公司
金叶珠宝	金叶珠宝股份有限公司
天津汽车模具股份有限公司	天津汽车模具股份有限公司
天汽模	天津汽车模具股份有限公司
北京万通地产股份有限公司	北京万通地产股份有限公司
万通地产	北京万通地产股份有限公司
深圳市瑞丰光电子股份有限公司	深圳市瑞丰光电子股份有限公司
瑞丰光电	深圳市瑞丰光电子股份有限公司
天津优联投资发展集团有限公司	天津优联投资发展集团有限公司
天津优联	天津优联投资发展集团有限公司
同方股份有限公司	同方股份有限公司
同方股份.*清华同方	同方股份有限公司
四川天齐锂业股份有限公司	四川天齐锂业股份有限公司
天齐锂业	四川天齐锂业股份有限公司
安徽国风塑业股份有限公司	安徽国风塑业股份有限公司
国风塑业	安徽国风塑业股份有限公司
天马轴承集团股份有限公司	天马轴承集团股份有限公司
天马股份	天马轴承集团股份有限公司
金蝶国际软件集团有限公司	金蝶国际软件集团有限公司
金蝶软件	金蝶国际软件集团有限公司
深圳万润科技股份有限公司	深圳万润科技股份有限公司
万润科技	深圳万润科技股份有限公司
内蒙古金宇集团股份有限公司	内蒙古金宇集团股份有限公司
金宇集团	内蒙古金宇集团股份有限公司
爱立信公司	爱立信公司
爱立信	爱立信公司
河北承德露露股份有限公司	河北承德露露股份有限公司
承德露露	河北承德露露股份有限公司
宁波慈星股份有限公司	宁波慈星股份有限公司
慈星股份	宁波慈星股份有限公司
全迪信通集团公司	全迪信通集团公司
迪信通	全迪信通集团公司
山东恒邦冶炼股份有限公司	山东恒邦冶炼股份有限公司
恒邦股份	山东恒邦冶炼股份有限公司
中垦农业资源开发股份有限公司	中垦农业资源开发股份有限公司
\\*ST中农	中垦农业资源开发股份有限公司
芜湖长信科技股份有限公司	芜湖长信科技股份有限公司
长信科技	芜湖长信科技股份有限公司
广东韶能集团股份有限公司	广东韶能集团股份有限公司
韶能股份	广东韶能集团股份有限公司
金花企业(集团)股份有限公司	金花企业(集团)股份有限公司
金花股份	金花企业(集团)股份有限公司
大连金牛股份有限公司	大连金牛股份有限公司
大连金牛	大连金牛股份有限公司
青岛泰发集团股份有限公司	青岛泰发集团股份有限公司
泰发集团	青岛泰发集团股份有限公司
江苏新宁现代物流股份有限公司	江苏新宁现代物流股份有限公司
新宁物流	江苏新宁现代物流股份有限公司
深圳欧菲光科技股份有限公司	深圳欧菲光科技股份有限公司
欧菲光	深圳欧菲光科技股份有限公司
中航黑豹股份有限公司	中航黑豹股份有限公司
中航黑豹	中航黑豹股份有限公司
东方财富网	东方财富网
东方财富网	东方财富网
鲁西化工集团股份有限公司	鲁西化工集团股份有限公司
鲁西化工	鲁西化工集团股份有限公司
新浪公司	新浪公司
新浪	新浪公司
山东高速路桥集团股份有限公司	山东高速路桥集团股份有限公司
山东路桥	山东高速路桥集团股份有限公司
工银瑞信基金管理有限公司	工银瑞信基金管理有限公司
工银瑞信.*工银瑞信基金公司	工银瑞信基金管理有限公司
浙江报喜鸟服饰股份有限公司	浙江报喜鸟服饰股份有限公司
报喜鸟	浙江报喜鸟服饰股份有限公司
美国纽约人寿保险公司	美国纽约人寿保险公司
纽约人寿	美国纽约人寿保险公司
江苏三房巷实业股份有限公司	江苏三房巷实业股份有限公司
三房巷	江苏三房巷实业股份有限公司
中铁集装箱运输有限责任公司	中铁集装箱运输有限责任公司
中铁集装箱运输	中铁集装箱运输有限责任公司
水利集团（中国）有限公司	水利集团（中国）有限公司
水利集团	水利集团（中国）有限公司
京东方科技集团股份有限公司	京东方科技集团股份有限公司
京东方.*京东方A.*京东方Ａ	京东方科技集团股份有限公司
华帝股份有限公司	华帝股份有限公司
华帝股份	华帝股份有限公司
中珠控股股份有限公司	中珠控股股份有限公司
中珠控股	中珠控股股份有限公司
海洋石油工程股份有限公司	海洋石油工程股份有限公司
海油工程	海洋石油工程股份有限公司
通化金马药业集团股份有限公司	通化金马药业集团股份有限公司
通化金马	通化金马药业集团股份有限公司
二重集团(德阳)重型装备股份有限公司	二重集团(德阳)重型装备股份有限公司
二重重装	二重集团(德阳)重型装备股份有限公司
深圳金信诺高新技术股份有限公司	深圳金信诺高新技术股份有限公司
金信诺	深圳金信诺高新技术股份有限公司
陶氏化学	陶氏化学
陶氏化学	陶氏化学
山西焦煤集团公司	山西焦煤集团公司
山西焦煤	山西焦煤集团公司
北京碧水源科技股份有限公司	北京碧水源科技股份有限公司
碧水源.*北京碧水源	北京碧水源科技股份有限公司
江苏新城房产股份有限公司	江苏新城房产股份有限公司
江苏新城	江苏新城房产股份有限公司
福建中福实业股份有限公司	福建中福实业股份有限公司
中福实业	福建中福实业股份有限公司
Yahoo！	Yahoo！
雅虎	Yahoo！
金川集团有限公司	金川集团有限公司
金川集团	金川集团有限公司
江苏恒立高压油缸股份有限公司	江苏恒立高压油缸股份有限公司
恒立油缸	江苏恒立高压油缸股份有限公司
海富通基金管理有限公司	海富通基金管理有限公司
海富通	海富通基金管理有限公司
长航凤凰股份有限公司	长航凤凰股份有限公司
长航凤凰.*\\*ST凤凰	长航凤凰股份有限公司
立邦涂料有限公司	立邦涂料有限公司
立邦涂料	立邦涂料有限公司
武汉市汉商集团股份有限公司	武汉市汉商集团股份有限公司
汉商集团	武汉市汉商集团股份有限公司
重庆四维控股集团股份有限公司	重庆四维控股集团股份有限公司
四维控股	重庆四维控股集团股份有限公司
东盛科技股份有限公司	东盛科技股份有限公司
ST东盛	东盛科技股份有限公司
江苏江淮动力股份有限公司	江苏江淮动力股份有限公司
江淮动力	江苏江淮动力股份有限公司
重庆美心集团	重庆美心集团
美心集团	重庆美心集团
四川明天精细化工有限责任公司	四川明天精细化工有限责任公司
明天精化	四川明天精细化工有限责任公司
同方国芯电子股份有限公司	同方国芯电子股份有限公司
同方国芯	同方国芯电子股份有限公司
万向德农股份有限公司	万向德农股份有限公司
万向德农	万向德农股份有限公司
江苏双登集团	江苏双登集团
双登	江苏双登集团
厦门建发股份有限公司	厦门建发股份有限公司
建发股份	厦门建发股份有限公司
永安保险公司	永安保险公司
永安保险	永安保险公司
哈尔滨轴承制造有限公司	哈尔滨轴承制造有限公司
哈轴	哈尔滨轴承制造有限公司
美国墨菲石油公司	美国墨菲石油公司
墨菲石油	美国墨菲石油公司
山东东阿阿胶股份有限公司	山东东阿阿胶股份有限公司
东阿阿胶	山东东阿阿胶股份有限公司
佛山塑料集团股份有限公司	佛山塑料集团股份有限公司
佛塑股份	佛山塑料集团股份有限公司
江西民生集团有限公司	江西民生集团有限公司
九江民生集团	江西民生集团有限公司
唐山冀东装备工程股份有限公司	唐山冀东装备工程股份有限公司
冀东装备	唐山冀东装备工程股份有限公司
深圳日海通讯技术股份有限公司	深圳日海通讯技术股份有限公司
日海通讯	深圳日海通讯技术股份有限公司
柳州两面针股份有限公司	柳州两面针股份有限公司
两面针	柳州两面针股份有限公司
湖北洪城通用机械股份有限公司	湖北洪城通用机械股份有限公司
洪城股份	湖北洪城通用机械股份有限公司
西安民生集团股份有限公司	西安民生集团股份有限公司
西安民生	西安民生集团股份有限公司
江西黑猫炭黑股份有限公司	江西黑猫炭黑股份有限公司
黑猫股份	江西黑猫炭黑股份有限公司
积成电子股份有限公司	积成电子股份有限公司
积成电子	积成电子股份有限公司
北京东方通科技股份有限公司	北京东方通科技股份有限公司
东方通	北京东方通科技股份有限公司
天津膜天膜科技股份有限公司	天津膜天膜科技股份有限公司
津膜科技	天津膜天膜科技股份有限公司
潍坊北大青鸟华光科技股份有限公司	潍坊北大青鸟华光科技股份有限公司
青鸟华光	潍坊北大青鸟华光科技股份有限公司
西安隆基硅材料股份有限公司	西安隆基硅材料股份有限公司
隆基股份	西安隆基硅材料股份有限公司
海南瑞泽新型建材股份有限公司	海南瑞泽新型建材股份有限公司
海南瑞泽	海南瑞泽新型建材股份有限公司
红鼎创业投资有限公司	红鼎创业投资有限公司
红鼎创投	红鼎创业投资有限公司
中国扬子集团	中国扬子集团
扬子集团	中国扬子集团
四川北方硝化棉股份有限公司	四川北方硝化棉股份有限公司
北化股份	四川北方硝化棉股份有限公司
中山市大洋电机有限公司	中山市大洋电机有限公司
大洋电机	中山市大洋电机有限公司
青岛海信电器股份有限公司	青岛海信电器股份有限公司
海信电器	青岛海信电器股份有限公司
国兴融达地产股份有限公司	国兴融达地产股份有限公司
国兴地产	国兴融达地产股份有限公司
鼎晖投资基金管理公司	鼎晖投资基金管理公司
鼎晖投资	鼎晖投资基金管理公司
武汉光迅科技股份有限公司	武汉光迅科技股份有限公司
光迅科技	武汉光迅科技股份有限公司
养生堂有限公司	养生堂有限公司
养生堂	养生堂有限公司
宏发科技股份有限公司	宏发科技股份有限公司
宏发股份	宏发科技股份有限公司
华映科技（集团）股份有限公司	华映科技（集团）股份有限公司
华映科技	华映科技（集团）股份有限公司
上海绿地建设集团有限公司	上海绿地建设集团有限公司
绿地集团	上海绿地建设集团有限公司
无锡威孚高科技集团股份有限公司	无锡威孚高科技集团股份有限公司
威孚高科	无锡威孚高科技集团股份有限公司
浙江华门房地产集团有限公司	浙江华门房地产集团有限公司
华门集团	浙江华门房地产集团有限公司
福建冠福现代家用股份有限公司	福建冠福现代家用股份有限公司
冠福家用	福建冠福现代家用股份有限公司
北京七星华创电子股份有限公司	北京七星华创电子股份有限公司
七星电子	北京七星华创电子股份有限公司
埃森哲公司	埃森哲公司
埃森哲	埃森哲公司
亿晶光电科技股份有限公司	亿晶光电科技股份有限公司
亿晶光电	亿晶光电科技股份有限公司
亿城集团股份有限公司	亿城集团股份有限公司
亿城股份	亿城集团股份有限公司
欣龙控股（集团）股份有限公司	欣龙控股（集团）股份有限公司
欣龙控股	欣龙控股（集团）股份有限公司
比利时联合银行	比利时联合银行
比利时联合银行	比利时联合银行
中国葛洲坝集团股份有限公司	中国葛洲坝集团股份有限公司
葛洲坝	中国葛洲坝集团股份有限公司
新疆啤酒花股份有限公司	新疆啤酒花股份有限公司
啤酒花	新疆啤酒花股份有限公司
贵州红星发展股份有限公司	贵州红星发展股份有限公司
红星发展	贵州红星发展股份有限公司
思科系统公司	思科系统公司
思科公司	思科系统公司
国光电器股份有限公司	国光电器股份有限公司
国光电器	国光电器股份有限公司
新疆友好(集团)股份有限公司	新疆友好(集团)股份有限公司
友好集团	新疆友好(集团)股份有限公司
江苏核电有限公司	江苏核电有限公司
江苏核电	江苏核电有限公司
河南汉威电子股份有限公司	河南汉威电子股份有限公司
汉威电子	河南汉威电子股份有限公司
天合光能有限公司	天合光能有限公司
天合光能	天合光能有限公司
上海鼎立科技发展(集团)股份有限公司	上海鼎立科技发展(集团)股份有限公司
鼎立股份	上海鼎立科技发展(集团)股份有限公司
青岛丽东化工有限公司	青岛丽东化工有限公司
丽东化工	青岛丽东化工有限公司
杭州中威电子股份有限公司	杭州中威电子股份有限公司
中威电子	杭州中威电子股份有限公司
信达国际控股有限公司	信达国际控股有限公司
信达国际	信达国际控股有限公司
武汉银泰科技电源股份有限公司	武汉银泰科技电源股份有限公司
银泰科技	武汉银泰科技电源股份有限公司
潜能恒信能源技术股份有限公司	潜能恒信能源技术股份有限公司
潜能恒信	潜能恒信能源技术股份有限公司
中水集团远洋股份有限公司	中水集团远洋股份有限公司
中水渔业	中水集团远洋股份有限公司
桂林集琦药业股份有限公司	桂林集琦药业股份有限公司
S\\*ST集琦	桂林集琦药业股份有限公司
必和必拓公司	必和必拓公司
必和必拓	必和必拓公司
广州友谊集团股份有限公司	广州友谊集团股份有限公司
广州友谊	广州友谊集团股份有限公司
辽宁华锦通达化工股份有限公司	辽宁华锦通达化工股份有限公司
辽通化工	辽宁华锦通达化工股份有限公司
石药集团有限公司	石药集团有限公司
石药集团	石药集团有限公司
湖南华天大酒店股份有限公司	湖南华天大酒店股份有限公司
华天酒店	湖南华天大酒店股份有限公司
上海东富龙科技股份有限公司	上海东富龙科技股份有限公司
东富龙	上海东富龙科技股份有限公司
秦皇岛耀华玻璃股份有限公司	秦皇岛耀华玻璃股份有限公司
ST耀华	秦皇岛耀华玻璃股份有限公司
齐鲁制药有限公司	齐鲁制药有限公司
齐鲁制药	齐鲁制药有限公司
中粮地产(集团)股份有限公司	中粮地产(集团)股份有限公司
中粮地产	中粮地产(集团)股份有限公司
歌尔声学股份有限公司	歌尔声学股份有限公司
歌尔声学	歌尔声学股份有限公司
山东航空股份有限公司	山东航空股份有限公司
山东航空.*山航Ｂ	山东航空股份有限公司
福建元力活性炭股份有限公司	福建元力活性炭股份有限公司
元力股份	福建元力活性炭股份有限公司
郴州市金贵银业股份有限公司	郴州市金贵银业股份有限公司
金贵银业	郴州市金贵银业股份有限公司
黄河新闻网	黄河新闻网
黄河新闻网	黄河新闻网
江苏恩华药业股份有限公司	江苏恩华药业股份有限公司
恩华药业	江苏恩华药业股份有限公司
FabbricaItalianadiAutomobiliTorino	FabbricaItalianadiAutomobiliTorino
菲亚特	FabbricaItalianadiAutomobiliTorino
厦门三五互联科技股份有限公司	厦门三五互联科技股份有限公司
三五互联	厦门三五互联科技股份有限公司
山东高速股份有限公司	山东高速股份有限公司
山东高速	山东高速股份有限公司
文华财经	文华财经
文华财经	文华财经
重庆银行股份有限公司	重庆银行股份有限公司
重庆银行	重庆银行股份有限公司
英大泰和人寿保险股份有限公司	英大泰和人寿保险股份有限公司
英大人寿	英大泰和人寿保险股份有限公司
江阴中南重工股份有限公司	江阴中南重工股份有限公司
中南重工	江阴中南重工股份有限公司
中国核工业集团公司	中国核工业集团公司
中核集团公司	中国核工业集团公司
广西皇氏甲天下乳业股份有限公司	广西皇氏甲天下乳业股份有限公司
皇氏乳业	广西皇氏甲天下乳业股份有限公司
山东大成农药股份有限公司	山东大成农药股份有限公司
大成股份	山东大成农药股份有限公司
中银基金管理有限公司	中银基金管理有限公司
中银基金	中银基金管理有限公司
易观国际	易观国际
易观国际	易观国际
上海界龙实业集团股份有限公司	上海界龙实业集团股份有限公司
界龙实业	上海界龙实业集团股份有限公司
英特尔投资	英特尔投资
英特尔投资	英特尔投资
汇仁集团	汇仁集团
汇仁	汇仁集团
广东星河生物科技股份有限公司	广东星河生物科技股份有限公司
星河生物	广东星河生物科技股份有限公司
民生人寿保险股份有限公司	民生人寿保险股份有限公司
民生人寿	民生人寿保险股份有限公司
上海吉祥航空有限公司	上海吉祥航空有限公司
吉祥航空	上海吉祥航空有限公司
徐州海伦哲专用车辆股份有限公司	徐州海伦哲专用车辆股份有限公司
海伦哲	徐州海伦哲专用车辆股份有限公司
云南锡业股份有限公司	云南锡业股份有限公司
锡业股份	云南锡业股份有限公司
山东胜利股份有限公司	山东胜利股份有限公司
胜利股份	山东胜利股份有限公司
深圳高速公路股份有限公司	深圳高速公路股份有限公司
深高速	深圳高速公路股份有限公司
铁法煤业（集团）有限责任公司	铁法煤业（集团）有限责任公司
铁煤集团	铁法煤业（集团）有限责任公司
中国安徽在线网站	中国安徽在线网站
中安在线	中国安徽在线网站
天泽信息产业股份有限公司	天泽信息产业股份有限公司
天泽信息	天泽信息产业股份有限公司
英国伊朗石油公司	英国伊朗石油公司
英国石油	英国伊朗石油公司
南洋航运集团股份有限公司	南洋航运集团股份有限公司
南洋航运	南洋航运集团股份有限公司
百事可乐公司	百事可乐公司
百事可乐	百事可乐公司
中国东方红卫星股份有限公司	中国东方红卫星股份有限公司
中国卫星	中国东方红卫星股份有限公司
广州白云山医药集团股份有限公司	广州白云山医药集团股份有限公司
白云山	广州白云山医药集团股份有限公司
中国电力国际发展有限公司	中国电力国际发展有限公司
中国电力	中国电力国际发展有限公司
中国纺织机械股份有限公司	中国纺织机械股份有限公司
中国纺机	中国纺织机械股份有限公司
浙江日报报业集团	浙江日报报业集团
浙江日报集团	浙江日报报业集团
国电长源电力股份有限公司	国电长源电力股份有限公司
长源电力	国电长源电力股份有限公司
21世纪商业评论	21世纪商业评论
21世纪商业评论	21世纪商业评论
美国泰科国际有限公司	美国泰科国际有限公司
泰科国际	美国泰科国际有限公司
江苏省交通科学研究院股份有限公司	江苏省交通科学研究院股份有限公司
苏交科	江苏省交通科学研究院股份有限公司
棕榈园林股份有限公司	棕榈园林股份有限公司
棕榈园林	棕榈园林股份有限公司
福建福晶科技股份有限公司	福建福晶科技股份有限公司
福晶科技	福建福晶科技股份有限公司
北京光线传媒股份有限公司	北京光线传媒股份有限公司
光线传媒	北京光线传媒股份有限公司
中国振华(集团)科技股份有限公司	中国振华(集团)科技股份有限公司
振华科技	中国振华(集团)科技股份有限公司
吉象木业公司	吉象木业公司
吉象木业	吉象木业公司
江苏双沟酒业股份有限公司	江苏双沟酒业股份有限公司
双沟集团	江苏双沟酒业股份有限公司
MerrillLynch	MerrillLynch
美林银行	MerrillLynch
北京物美商业集团股份有限公司	北京物美商业集团股份有限公司
物美集团	北京物美商业集团股份有限公司
鹏博士电信传媒集团股份有限公司	鹏博士电信传媒集团股份有限公司
鹏博士	鹏博士电信传媒集团股份有限公司
四川大西洋焊接材料股份有限公司	四川大西洋焊接材料股份有限公司
大西洋	四川大西洋焊接材料股份有限公司
银邦金属复合材料股份有限公司	银邦金属复合材料股份有限公司
银邦股份	银邦金属复合材料股份有限公司
龙湖地产	龙湖地产
龙湖集团	龙湖地产
潇湘晨报	潇湘晨报
潇湘晨报	潇湘晨报
长春奥普光电技术股份有限公司	长春奥普光电技术股份有限公司
奥普光电	长春奥普光电技术股份有限公司
四川川投能源股份有限公司	四川川投能源股份有限公司
川投能源	四川川投能源股份有限公司
北京昊融兴业典当行有限公司	北京昊融兴业典当行有限公司
昊融兴业典当	北京昊融兴业典当行有限公司
上海徐家汇商城股份有限公司	上海徐家汇商城股份有限公司
徐家汇	上海徐家汇商城股份有限公司
北京瑞星信息技术有限公司	北京瑞星信息技术有限公司
瑞星	北京瑞星信息技术有限公司
南京银行股份有限公司	南京银行股份有限公司
南京银行	南京银行股份有限公司
千龙网	千龙网
千龙网	千龙网
四川川润股份有限公司	四川川润股份有限公司
川润股份	四川川润股份有限公司
sanqindushibao	sanqindushibao
三秦都市报	sanqindushibao
广汽长丰汽车股份有限公司	广汽长丰汽车股份有限公司
广汽长丰	广汽长丰汽车股份有限公司
广东欧浦钢铁物流股份有限公司	广东欧浦钢铁物流股份有限公司
欧浦钢网	广东欧浦钢铁物流股份有限公司
三维通信股份有限公司	三维通信股份有限公司
三维通信	三维通信股份有限公司
桂林莱茵生物科技股份有限公司	桂林莱茵生物科技股份有限公司
莱茵生物	桂林莱茵生物科技股份有限公司
上海国盛典当有限公司	上海国盛典当有限公司
国盛典当	上海国盛典当有限公司
招商信诺人寿保险有限公司	招商信诺人寿保险有限公司
招商信诺	招商信诺人寿保险有限公司
福建新大陆电脑股份有限公司	福建新大陆电脑股份有限公司
新大陆	福建新大陆电脑股份有限公司
大同煤矿集团公司	大同煤矿集团公司
同煤集团	大同煤矿集团公司
沈阳新松机器人自动化股份有限公司	沈阳新松机器人自动化股份有限公司
机器人	沈阳新松机器人自动化股份有限公司
TOM集团有限公司	TOM集团有限公司
TOM集团	TOM集团有限公司
湖南亚华乳业有限公司	湖南亚华乳业有限公司
亚华乳业	湖南亚华乳业有限公司
浙江苏泊尔股份有限公司	浙江苏泊尔股份有限公司
苏泊尔	浙江苏泊尔股份有限公司
盛京银行	盛京银行
盛京银行	盛京银行
四川高速公路建设开发总公司	四川高速公路建设开发总公司
川高	四川高速公路建设开发总公司
深圳赤湾港航股份有限公司	深圳赤湾港航股份有限公司
深赤湾.*深赤湾Ａ	深圳赤湾港航股份有限公司
上海威尔泰工业自动化股份有限公司	上海威尔泰工业自动化股份有限公司
威尔泰	上海威尔泰工业自动化股份有限公司
半月谈	半月谈
半月谈	半月谈
国泰人寿保险有限责任公司	国泰人寿保险有限责任公司
国泰人寿	国泰人寿保险有限责任公司
西安标准工业股份有限公司	西安标准工业股份有限公司
标准股份	西安标准工业股份有限公司
珠海市博元投资股份有限公司	珠海市博元投资股份有限公司
博元投资	珠海市博元投资股份有限公司
深圳华强实业股份有限公司	深圳华强实业股份有限公司
深圳华强	深圳华强实业股份有限公司
国美电器	国美电器
国美电器	国美电器
福建雪人股份有限公司	福建雪人股份有限公司
雪人股份	福建雪人股份有限公司
合肥丰乐种业股份有限公司	合肥丰乐种业股份有限公司
丰乐种业	合肥丰乐种业股份有限公司
杭州钢铁集团公司	杭州钢铁集团公司
杭钢集团	杭州钢铁集团公司
本田汽车公司	本田汽车公司
本田汽车	本田汽车公司
北京宝盛典当有限公司	北京宝盛典当有限公司
宝盛典当	北京宝盛典当有限公司
浙江万好万家实业股份有限公司	浙江万好万家实业股份有限公司
万好万家	浙江万好万家实业股份有限公司
宜宾天原集团股份有限公司	宜宾天原集团股份有限公司
天原集团	宜宾天原集团股份有限公司
万科企业股份有限公司	万科企业股份有限公司
万科.*万科A.*万科Ａ	万科企业股份有限公司
浙江一新制药股份有限公司	浙江一新制药股份有限公司
一新制药	浙江一新制药股份有限公司
山东齐星铁塔科技股份有限公司	山东齐星铁塔科技股份有限公司
齐星铁塔	山东齐星铁塔科技股份有限公司
北京双鹤药业股份有限公司	北京双鹤药业股份有限公司
双鹤药业	北京双鹤药业股份有限公司
博爱新开源制药股份有限公司	博爱新开源制药股份有限公司
新开源	博爱新开源制药股份有限公司
日照银行	日照银行
日照银行	日照银行
晋亿实业股份有限公司	晋亿实业股份有限公司
晋亿实业	晋亿实业股份有限公司
安海斯-布希英博公司	安海斯-布希英博公司
安海斯-布希英博	安海斯-布希英博公司
湖北潜江制药股份有限公司	湖北潜江制药股份有限公司
ST潜药	湖北潜江制药股份有限公司
宁波三星电气股份有限公司	宁波三星电气股份有限公司
三星电气	宁波三星电气股份有限公司
武汉地产投资开发集团有限公司	武汉地产投资开发集团有限公司
武汉地产	武汉地产投资开发集团有限公司
美国西北相互人寿保险公司	美国西北相互人寿保险公司
西北相互	美国西北相互人寿保险公司
德州新闻网	德州新闻网
德州新闻网	德州新闻网
Cartier	Cartier
卡地亚	Cartier
福安药业(集团)股份有限公司	福安药业(集团)股份有限公司
福安药业	福安药业(集团)股份有限公司
中海网络科技股份有限公司	中海网络科技股份有限公司
中海科技	中海网络科技股份有限公司
中国石油兰州石化公司	中国石油兰州石化公司
兰州石化	中国石油兰州石化公司
苏州中茵集团有限公司	苏州中茵集团有限公司
中茵集团	苏州中茵集团有限公司
桂林天和药业股份有限公司	桂林天和药业股份有限公司
天和药业	桂林天和药业股份有限公司
松下电器株式会社	松下电器株式会社
松下电器	松下电器株式会社
浙江龙盛集团股份有限公司	浙江龙盛集团股份有限公司
浙江龙盛	浙江龙盛集团股份有限公司
长安责任保险股份有限公司	长安责任保险股份有限公司
长安责任险	长安责任保险股份有限公司
深圳市长盈精密技术股份有限公司	深圳市长盈精密技术股份有限公司
长盈精密	深圳市长盈精密技术股份有限公司
远程电缆股份有限公司	远程电缆股份有限公司
远程电缆	远程电缆股份有限公司
巨化集团公司	巨化集团公司
巨化集团	巨化集团公司
安信证券股份有限公司	安信证券股份有限公司
安信证券	安信证券股份有限公司
沈阳化工股份有限公司	沈阳化工股份有限公司
沈阳化工	沈阳化工股份有限公司
安徽安凯汽车股份有限公司	安徽安凯汽车股份有限公司
安凯客车	安徽安凯汽车股份有限公司
安徽皖通高速公路股份有限公司	安徽皖通高速公路股份有限公司
皖通高速	安徽皖通高速公路股份有限公司
河南省西峡汽车水泵股份有限公司	河南省西峡汽车水泵股份有限公司
西泵股份	河南省西峡汽车水泵股份有限公司
万德国际集团	万德国际集团
万德集团	万德国际集团
浙江万丰奥威汽轮股份有限公司	浙江万丰奥威汽轮股份有限公司
万丰奥威	浙江万丰奥威汽轮股份有限公司
湖北楚天高速公路股份有限公司	湖北楚天高速公路股份有限公司
楚天高速	湖北楚天高速公路股份有限公司
华仁药业股份有限公司	华仁药业股份有限公司
华仁药业	华仁药业股份有限公司
中国移动通信集团公司	中国移动通信集团公司
中国移动通信.*中国移动	中国移动通信集团公司
中国华录集团有限公司	中国华录集团有限公司
华录集团	中国华录集团有限公司
梅花生物科技集团股份有限公司	梅花生物科技集团股份有限公司
梅花集团	梅花生物科技集团股份有限公司
浙江省物产集团公司	浙江省物产集团公司
浙江省物产集团.*浙江物产	浙江省物产集团公司
金健米业股份有限公司	金健米业股份有限公司
金健米业	金健米业股份有限公司
福州市商业银行股份有限公司	福州市商业银行股份有限公司
福州市商业银行	福州市商业银行股份有限公司
北广传媒集团	北广传媒集团
北广传媒	北广传媒集团
东方财富信息股份有限公司	东方财富信息股份有限公司
东方财富	东方财富信息股份有限公司
安徽鑫龙电器股份有限公司	安徽鑫龙电器股份有限公司
鑫龙电器	安徽鑫龙电器股份有限公司
上海金鑫典当行有限责任公司	上海金鑫典当行有限责任公司
金鑫典当	上海金鑫典当行有限责任公司
怡球金属资源再生(中国)股份有限公司	怡球金属资源再生(中国)股份有限公司
怡球资源	怡球金属资源再生(中国)股份有限公司
吉林金浦钛业股份有限公司	吉林金浦钛业股份有限公司
金浦钛业	吉林金浦钛业股份有限公司
广发证券股份有限公司	广发证券股份有限公司
广发证券	广发证券股份有限公司
上海申达股份有限公司	上海申达股份有限公司
申达股份	上海申达股份有限公司
江阴海达橡塑股份有限公司	江阴海达橡塑股份有限公司
海达股份	江阴海达橡塑股份有限公司
加拿大皇家银行	加拿大皇家银行
加拿大皇家银行	加拿大皇家银行
重庆钢铁股份有限公司	重庆钢铁股份有限公司
重庆钢铁	重庆钢铁股份有限公司
嘉里建设有限公司	嘉里建设有限公司
嘉里建设	嘉里建设有限公司
河北经济日报	河北经济日报
河北经济日报	河北经济日报
淄博商厦股份有限公司	淄博商厦股份有限公司
淄博商厦	淄博商厦股份有限公司
华塑控股股份有限公司	华塑控股股份有限公司
华塑控股.*\\*ST华塑	华塑控股股份有限公司
中船江南重工股份有限公司	中船江南重工股份有限公司
中船股份	中船江南重工股份有限公司
上海斯米克控股股份有限公司	上海斯米克控股股份有限公司
斯米克.*\\*ST上控	上海斯米克控股股份有限公司
AseaBrownBoveriLtd.	AseaBrownBoveriLtd.
ABB	AseaBrownBoveriLtd.
广西运德汽车运输集团有限公司	广西运德汽车运输集团有限公司
运德集团	广西运德汽车运输集团有限公司
英国路透集团	英国路透集团
路透	英国路透集团
旭光资源有限公司	旭光资源有限公司
旭光资源	旭光资源有限公司
上海九龙山旅游股份有限公司	上海九龙山旅游股份有限公司
九龙山	上海九龙山旅游股份有限公司
上海飞乐音响股份有限公司	上海飞乐音响股份有限公司
飞乐音响	上海飞乐音响股份有限公司
北京华隆典当有限责任公司	北京华隆典当有限责任公司
华隆典当	北京华隆典当有限责任公司
成都利君实业股份有限公司	成都利君实业股份有限公司
利君股份	成都利君实业股份有限公司
西安开元投资集团股份有限公司	西安开元投资集团股份有限公司
开元投资	西安开元投资集团股份有限公司
洛阳隆华传热节能股份有限公司	洛阳隆华传热节能股份有限公司
隆华节能	洛阳隆华传热节能股份有限公司
英大证券有限责任公司	英大证券有限责任公司
英大证券	英大证券有限责任公司
承德南江股份有限公司	承德南江股份有限公司
南江B	承德南江股份有限公司
江苏东光微电子股份有限公司	江苏东光微电子股份有限公司
东光微电	江苏东光微电子股份有限公司
西藏珠峰工业股份有限公司	西藏珠峰工业股份有限公司
西藏珠峰.*ST珠峰	西藏珠峰工业股份有限公司
联邦快递集团	联邦快递集团
联邦快递	联邦快递集团
中兴-沈阳商业大厦集团股份有限公司	中兴-沈阳商业大厦集团股份有限公司
中兴商业	中兴-沈阳商业大厦集团股份有限公司
龙湖房地产开发有限公司	龙湖房地产开发有限公司
龙湖地产	龙湖房地产开发有限公司
重庆路桥股份有限公司	重庆路桥股份有限公司
重庆路桥	重庆路桥股份有限公司
莎莎国际控股有限公司	莎莎国际控股有限公司
莎莎国际	莎莎国际控股有限公司
江西恒大高新技术股份有限公司	江西恒大高新技术股份有限公司
恒大高新	江西恒大高新技术股份有限公司
福建三钢闽光股份有限公司	福建三钢闽光股份有限公司
三钢闽光	福建三钢闽光股份有限公司
东风汽车股份有限公司	东风汽车股份有限公司
东风汽车	东风汽车股份有限公司
江苏中洋集团股份有限公司	江苏中洋集团股份有限公司
中洋集团	江苏中洋集团股份有限公司
浙江正泰电器股份有限公司	浙江正泰电器股份有限公司
正泰电器	浙江正泰电器股份有限公司
顺驰中国控股有限公司	顺驰中国控股有限公司
顺驰中国	顺驰中国控股有限公司
辽宁成大股份有限公司	辽宁成大股份有限公司
辽宁成大	辽宁成大股份有限公司
深圳市迪威视讯股份有限公司	深圳市迪威视讯股份有限公司
迪威视讯	深圳市迪威视讯股份有限公司
浙江迪安诊断技术股份有限公司	浙江迪安诊断技术股份有限公司
迪安诊断	浙江迪安诊断技术股份有限公司
张家界旅游开发股份有限公司	张家界旅游开发股份有限公司
SST张股	张家界旅游开发股份有限公司
马鞍山方圆回转支承股份有限公司	马鞍山方圆回转支承股份有限公司
方圆支承	马鞍山方圆回转支承股份有限公司
深圳本鲁克斯实业股份有限公司	深圳本鲁克斯实业股份有限公司
深本实	深圳本鲁克斯实业股份有限公司
夏普	夏普
夏普	夏普
徐工集团工程机械股份有限公司	徐工集团工程机械股份有限公司
徐工机械	徐工集团工程机械股份有限公司
江海证券经纪有限责任公司	江海证券经纪有限责任公司
江海证券	江海证券经纪有限责任公司
河南神火煤电股份有限公司	河南神火煤电股份有限公司
神火股份	河南神火煤电股份有限公司
普洛药业股份有限公司	普洛药业股份有限公司
普洛药业	普洛药业股份有限公司
北海市北海港股份有限公司	北海市北海港股份有限公司
北海港	北海市北海港股份有限公司
深圳市迅雷网络技术有限公司	深圳市迅雷网络技术有限公司
迅雷	深圳市迅雷网络技术有限公司
浙江大华技术股份有限公司	浙江大华技术股份有限公司
大华股份	浙江大华技术股份有限公司
中颖电子股份有限公司	中颖电子股份有限公司
中颖电子	中颖电子股份有限公司
福马食品集团	福马食品集团
福马食品	福马食品集团
山东日科化学股份有限公司	山东日科化学股份有限公司
日科化学	山东日科化学股份有限公司
广州东方宝龙汽车工业股份有限公司	广州东方宝龙汽车工业股份有限公司
ST宝龙	广州东方宝龙汽车工业股份有限公司
中体奥林匹克花园管理集团	中体奥林匹克花园管理集团
中体奥林匹克	中体奥林匹克花园管理集团
福建发展高速公路股份有限公司	福建发展高速公路股份有限公司
福建高速	福建发展高速公路股份有限公司
河南省淅川铝业（集团）有限公司	河南省淅川铝业（集团）有限公司
淅川铝业	河南省淅川铝业（集团）有限公司
铃木株式会社	铃木株式会社
铃木汽车	铃木株式会社
中国国际金融有限公司	中国国际金融有限公司
中金公司	中国国际金融有限公司
国睿科技股份有限公司	国睿科技股份有限公司
国睿科技	国睿科技股份有限公司
TheRoyalBankofScotlandGroupPublicLimitedCompany	TheRoyalBankofScotlandGroupPublicLimitedCompany
苏格兰皇家银行	TheRoyalBankofScotlandGroupPublicLimitedCompany
国投华靖电力控股股份有限公司	国投华靖电力控股股份有限公司
国投电力	国投华靖电力控股股份有限公司
新疆众和股份有限公司	新疆众和股份有限公司
新疆众和	新疆众和股份有限公司
东方金钰股份有限公司	东方金钰股份有限公司
东方金钰	东方金钰股份有限公司
湖北宜化化工股份有限公司	湖北宜化化工股份有限公司
湖北宜化	湖北宜化化工股份有限公司
江苏悦达投资股份有限公司	江苏悦达投资股份有限公司
悦达投资	江苏悦达投资股份有限公司
吉林亚泰(集团)股份有限公司	吉林亚泰(集团)股份有限公司
亚泰集团	吉林亚泰(集团)股份有限公司
德信无线通讯科技有限公司	德信无线通讯科技有限公司
德信无线	德信无线通讯科技有限公司
瀚蓝环境股份有限公司	瀚蓝环境股份有限公司
瀚蓝环境	瀚蓝环境股份有限公司
三菱东京日联银行	三菱东京日联银行
三菱东京日联银行	三菱东京日联银行
解放网－新闻晨报	解放网－新闻晨报
新闻晨报	解放网－新闻晨报
上海大江食品集团股份有限公司	上海大江食品集团股份有限公司
大江股份	上海大江食品集团股份有限公司
Chanle	Chanle
Chanle	Chanle
吉艾科技（北京）股份公司	吉艾科技（北京）股份公司
吉艾科技	吉艾科技（北京）股份公司
重庆西亚集团	重庆西亚集团
西亚集团	重庆西亚集团
广州广船国际股份有限公司	广州广船国际股份有限公司
广船国际	广州广船国际股份有限公司
中融国际信托有限公司	中融国际信托有限公司
中融信托	中融国际信托有限公司
新加坡航空有限公司	新加坡航空有限公司
新加坡航空	新加坡航空有限公司
辽宁时代万恒股份有限公司	辽宁时代万恒股份有限公司
时代万恒	辽宁时代万恒股份有限公司
四川高金食品股份有限公司	四川高金食品股份有限公司
高金食品	四川高金食品股份有限公司
成都卫士通信息产业股份有限公司	成都卫士通信息产业股份有限公司
卫士通	成都卫士通信息产业股份有限公司
天津鑫茂科技股份有限公司	天津鑫茂科技股份有限公司
鑫茂科技	天津鑫茂科技股份有限公司
上海九龙山股份有限公司	上海九龙山股份有限公司
九龙山	上海九龙山股份有限公司
朗源股份有限公司	朗源股份有限公司
朗源股份	朗源股份有限公司
广州万宝集团有限公司	广州万宝集团有限公司
万宝	广州万宝集团有限公司
湖南华升股份有限公司	湖南华升股份有限公司
华升股份	湖南华升股份有限公司
本溪钢铁集团公司	本溪钢铁集团公司
本钢	本溪钢铁集团公司
天津广宇发展股份有限公司	天津广宇发展股份有限公司
广宇发展	天津广宇发展股份有限公司
兰宝科技信息股份有限公司	兰宝科技信息股份有限公司
\\*ST兰宝	兰宝科技信息股份有限公司
大连长兴实业股份有限公司	大连长兴实业股份有限公司
长兴实业	大连长兴实业股份有限公司
泛海建设集团股份有限公司	泛海建设集团股份有限公司
泛海建设	泛海建设集团股份有限公司
雏鹰农牧集团股份有限公司	雏鹰农牧集团股份有限公司
雏鹰农牧	雏鹰农牧集团股份有限公司
瑞士瑞信银行	瑞士瑞信银行
瑞士信贷	瑞士瑞信银行
GUCCI	GUCCI
GUCCI	GUCCI
武汉中百集团股份有限公司	武汉中百集团股份有限公司
武汉中百	武汉中百集团股份有限公司
中国中钢集团	中国中钢集团
中钢集团	中国中钢集团
山东时风（集团）有限责任公司	山东时风（集团）有限责任公司
时风集团	山东时风（集团）有限责任公司
华兰生物工程股份有限公司	华兰生物工程股份有限公司
华兰生物	华兰生物工程股份有限公司
杭州初灵信息技术股份有限公司	杭州初灵信息技术股份有限公司
初灵信息	杭州初灵信息技术股份有限公司
北京雪迪龙科技股份有限公司	北京雪迪龙科技股份有限公司
雪迪龙	北京雪迪龙科技股份有限公司
青海华鼎实业股份有限公司	青海华鼎实业股份有限公司
青海华鼎	青海华鼎实业股份有限公司
河南豫能控股股份有限公司	河南豫能控股股份有限公司
豫能控股	河南豫能控股股份有限公司
三全食品股份有限公司	三全食品股份有限公司
三全食品	三全食品股份有限公司
越秀投资有限公司	越秀投资有限公司
越秀投资	越秀投资有限公司
江苏洋河酒厂股份有限公司	江苏洋河酒厂股份有限公司
洋河股份.*江苏洋河	江苏洋河酒厂股份有限公司
中国建设银行股份有限公司	中国建设银行股份有限公司
建设银行	中国建设银行股份有限公司
中国广东核电集团有限公司	中国广东核电集团有限公司
中广核	中国广东核电集团有限公司
侨兴环球	侨兴环球
侨兴环球	侨兴环球
成都银河磁体股份有限公司	成都银河磁体股份有限公司
银河磁体	成都银河磁体股份有限公司
安华农业保险股份有限公司	安华农业保险股份有限公司
安华农业险	安华农业保险股份有限公司
苏州天马精细化学品股份有限公司	苏州天马精细化学品股份有限公司
天马精化	苏州天马精细化学品股份有限公司
广东佳隆食品股份有限公司	广东佳隆食品股份有限公司
佳隆股份	广东佳隆食品股份有限公司
河南东方银星投资股份有限公司	河南东方银星投资股份有限公司
东方银星	河南东方银星投资股份有限公司
北京巴士股份有限公司	北京巴士股份有限公司
北京巴士	北京巴士股份有限公司
Bank-AmericaCorporation	Bank-AmericaCorporation
美国银行	Bank-AmericaCorporation
深圳市英威腾电气股份有限公司	深圳市英威腾电气股份有限公司
英威腾	深圳市英威腾电气股份有限公司
能源杂志	能源杂志
能源杂志	能源杂志
上海辅仁实业集团股份有限公司	上海辅仁实业集团股份有限公司
上海辅仁	上海辅仁实业集团股份有限公司
恒安标准人寿保险有限公司	恒安标准人寿保险有限公司
恒安标准人寿	恒安标准人寿保险有限公司
美国德尔福公司	美国德尔福公司
德尔福	美国德尔福公司
天奇自动化工程股份有限公司	天奇自动化工程股份有限公司
天奇股份	天奇自动化工程股份有限公司
沈阳博林特电梯集团股份有限公司	沈阳博林特电梯集团股份有限公司
博林特	沈阳博林特电梯集团股份有限公司
北京首都旅游股份有限公司	北京首都旅游股份有限公司
首旅股份	北京首都旅游股份有限公司
北京首航艾启威节能技术股份有限公司	北京首航艾启威节能技术股份有限公司
首航节能	北京首航艾启威节能技术股份有限公司
绍兴咸亨集团股份有限公司	绍兴咸亨集团股份有限公司
咸亨集团	绍兴咸亨集团股份有限公司
金盛人寿保险有限公司	金盛人寿保险有限公司
金盛人寿	金盛人寿保险有限公司
冀中能源股份有限公司	冀中能源股份有限公司
冀中能源	冀中能源股份有限公司
中国天津郁美净集团有限公司	中国天津郁美净集团有限公司
郁美净集团	中国天津郁美净集团有限公司
北京天鸿集团	北京天鸿集团
天鸿集团	北京天鸿集团
安徽神剑新材料股份有限公司	安徽神剑新材料股份有限公司
神剑股份	安徽神剑新材料股份有限公司
甘肃亚盛实业(集团)股份有限公司	甘肃亚盛实业(集团)股份有限公司
亚盛集团	甘肃亚盛实业(集团)股份有限公司
浙江金鹰股份有限公司	浙江金鹰股份有限公司
金鹰股份	浙江金鹰股份有限公司
四川成飞集成科技股份有限公司	四川成飞集成科技股份有限公司
成飞集成	四川成飞集成科技股份有限公司
德国安联保险集团	德国安联保险集团
安联保险	德国安联保险集团
长沙通程控股股份有限公司	长沙通程控股股份有限公司
通程控股	长沙通程控股股份有限公司
湖南天雁机械股份有限公司	湖南天雁机械股份有限公司
湖南天雁	湖南天雁机械股份有限公司
中国税务报	中国税务报
中国税务报	中国税务报
振兴生化股份有限公司	振兴生化股份有限公司
振兴生化.*\\*ST生化	振兴生化股份有限公司
深圳长城开发科技股份有限公司	深圳长城开发科技股份有限公司
长城开发.*长城开发科技	深圳长城开发科技股份有限公司
金山开发建设股份有限公司	金山开发建设股份有限公司
金山开发	金山开发建设股份有限公司
浙江伟星新型建材股份有限公司	浙江伟星新型建材股份有限公司
伟星新材	浙江伟星新型建材股份有限公司
中国证券业协会	中国证券业协会
中国证券业协会	中国证券业协会
俄罗斯联邦储蓄银行	俄罗斯联邦储蓄银行
联邦储蓄银行	俄罗斯联邦储蓄银行
新疆城建集团股份有限公司	新疆城建集团股份有限公司
新疆城建	新疆城建集团股份有限公司
山东泸河集团有限公司	山东泸河集团有限公司
山东泸河	山东泸河集团有限公司
深圳市银之杰科技股份有限公司	深圳市银之杰科技股份有限公司
银之杰	深圳市银之杰科技股份有限公司
方圆集团	方圆集团
方圆集团	方圆集团
苏宁环球股份有限公司	苏宁环球股份有限公司
苏宁环球	苏宁环球股份有限公司
天津永泰红磡集团	天津永泰红磡集团
天津永泰	天津永泰红磡集团
吉林电力股份有限公司	吉林电力股份有限公司
吉电股份	吉林电力股份有限公司
深圳市振业集团股份有限公司	深圳市振业集团股份有限公司
深振业A	深圳市振业集团股份有限公司
湘潭电机股份有限公司	湘潭电机股份有限公司
湘电股份	湘潭电机股份有限公司
宁波圣莱达电器股份有限公司	宁波圣莱达电器股份有限公司
圣莱达	宁波圣莱达电器股份有限公司
北京盛通印刷股份有限公司	北京盛通印刷股份有限公司
盛通股份	北京盛通印刷股份有限公司
鲁银投资集团股份有限公司	鲁银投资集团股份有限公司
鲁银投资	鲁银投资集团股份有限公司
武汉凯迪电力股份有限公司	武汉凯迪电力股份有限公司
凯迪电力	武汉凯迪电力股份有限公司
金正大生态工程集团股份有限公司	金正大生态工程集团股份有限公司
金正大	金正大生态工程集团股份有限公司
江苏国泰国际集团国贸股份有限公司	江苏国泰国际集团国贸股份有限公司
江苏国泰	江苏国泰国际集团国贸股份有限公司
锦州港股份有限公司	锦州港股份有限公司
锦州港	锦州港股份有限公司
修正药业集团	修正药业集团
修正药业	修正药业集团
东北高速公路股份有限公司	东北高速公路股份有限公司
东北高速	东北高速公路股份有限公司
北京民生典当有限责任公司	北京民生典当有限责任公司
民生典当	北京民生典当有限责任公司
浙江金洲管道科技股份有限公司	浙江金洲管道科技股份有限公司
金洲管道	浙江金洲管道科技股份有限公司
安阳钢铁股份有限公司	安阳钢铁股份有限公司
安阳钢铁	安阳钢铁股份有限公司
宣化钢铁集团公司	宣化钢铁集团公司
宣化钢铁	宣化钢铁集团公司
英国太古集团有限公司	英国太古集团有限公司
太古集团	英国太古集团有限公司
美国塔吉特公司简介	美国塔吉特公司简介
塔吉特	美国塔吉特公司简介
大帝集团	大帝集团
大帝集团	大帝集团
淡马锡控股公司	淡马锡控股公司
淡马锡控股	淡马锡控股公司
中国人民保险集团股份有限公司	中国人民保险集团股份有限公司
中国人保	中国人民保险集团股份有限公司
九州通医药集团股份有限公司	九州通医药集团股份有限公司
九州通	九州通医药集团股份有限公司
日本电气股份有限公司	日本电气股份有限公司
NEC	日本电气股份有限公司
汇丰晋信基金管理有限公司	汇丰晋信基金管理有限公司
汇丰晋信基金	汇丰晋信基金管理有限公司
宏昌电子材料股份有限公司	宏昌电子材料股份有限公司
宏昌电子	宏昌电子材料股份有限公司
成商集团股份有限公司	成商集团股份有限公司
成商集团	成商集团股份有限公司
江西昌九生物化工股份有限公司	江西昌九生物化工股份有限公司
昌九生化	江西昌九生物化工股份有限公司
北京中期期货经纪有限公司	北京中期期货经纪有限公司
北京中期	北京中期期货经纪有限公司
二十世纪福克斯电影公司	二十世纪福克斯电影公司
二十世纪福克斯电影	二十世纪福克斯电影公司
新疆国统管道股份有限公司	新疆国统管道股份有限公司
国统股份	新疆国统管道股份有限公司
浙江开创国际海洋资源股份有限公司	浙江开创国际海洋资源股份有限公司
开创国际	浙江开创国际海洋资源股份有限公司
华数传媒控股股份有限公司	华数传媒控股股份有限公司
华数传媒	华数传媒控股股份有限公司
宁夏新闻网	宁夏新闻网
宁夏新闻网	宁夏新闻网
香港富华国际集团	香港富华国际集团
富华国际集团	香港富华国际集团
深圳市汇川技术股份有限公司	深圳市汇川技术股份有限公司
汇川技术	深圳市汇川技术股份有限公司
银座集团股份有限公司	银座集团股份有限公司
银座股份	银座集团股份有限公司
徽商银行	徽商银行
徽商银行	徽商银行
西安达刚路面机械股份有限公司	西安达刚路面机械股份有限公司
达刚路机	西安达刚路面机械股份有限公司
安徽皖维高新材料股份有限公司	安徽皖维高新材料股份有限公司
皖维高新	安徽皖维高新材料股份有限公司
张家界导游网	张家界导游网
张家界导游网	张家界导游网
阳光新业地产股份有限公司	阳光新业地产股份有限公司
阳光股份	阳光新业地产股份有限公司
江苏宁沪高速公路股份有限公司	江苏宁沪高速公路股份有限公司
宁沪高速	江苏宁沪高速公路股份有限公司
华润万东医疗装备股份有限公司	华润万东医疗装备股份有限公司
华润万东	华润万东医疗装备股份有限公司
西安杨森制药有限责任公司	西安杨森制药有限责任公司
西安杨森	西安杨森制药有限责任公司
太平洋证券股份有限公司	太平洋证券股份有限公司
太平洋	太平洋证券股份有限公司
安徽华星化工股份有限公司	安徽华星化工股份有限公司
华星化工	安徽华星化工股份有限公司
华夏建通科技开发股份有限公司	华夏建通科技开发股份有限公司
华夏建通	华夏建通科技开发股份有限公司
韩国电力公司	韩国电力公司
韩国电力	韩国电力公司
浙江大东南股份有限公司	浙江大东南股份有限公司
大东南	浙江大东南股份有限公司
濮阳濮耐高温材料(集团)股份有限公司	濮阳濮耐高温材料(集团)股份有限公司
濮耐股份	濮阳濮耐高温材料(集团)股份有限公司
中海(海南)海盛船务股份有限公司	中海(海南)海盛船务股份有限公司
中海海盛	中海(海南)海盛船务股份有限公司
诺德基金管理有限公司	诺德基金管理有限公司
诺德基金	诺德基金管理有限公司
浙江宏磊铜业股份有限公司	浙江宏磊铜业股份有限公司
宏磊股份	浙江宏磊铜业股份有限公司
浙江帝龙新材料股份有限公司	浙江帝龙新材料股份有限公司
帝龙新材	浙江帝龙新材料股份有限公司
宁夏新日恒力钢丝绳股份有限公司	宁夏新日恒力钢丝绳股份有限公司
新日恒力	宁夏新日恒力钢丝绳股份有限公司
中铁快运股份有限公司	中铁快运股份有限公司
中铁快运	中铁快运股份有限公司
广东雷伊(集团)股份有限公司	广东雷伊(集团)股份有限公司
雷伊.*雷伊B	广东雷伊(集团)股份有限公司
中国航空工业集团公司	中国航空工业集团公司
中航工业	中国航空工业集团公司
江西华伍制动器股份有限公司	江西华伍制动器股份有限公司
华伍股份	江西华伍制动器股份有限公司
恒康天安人寿保险有限公司	恒康天安人寿保险有限公司
恒康天安人寿	恒康天安人寿保险有限公司
中国长江航运集团南京油运股份有限公司	中国长江航运集团南京油运股份有限公司
长航油运	中国长江航运集团南京油运股份有限公司
四川成渝高速公路股份有限公司	四川成渝高速公路股份有限公司
四川成渝.*成渝高速	四川成渝高速公路股份有限公司
芜湖海螺型材科技股份有限公司	芜湖海螺型材科技股份有限公司
海螺型材	芜湖海螺型材科技股份有限公司
铜陵中发三佳科技股份有限公司	铜陵中发三佳科技股份有限公司
中发科技	铜陵中发三佳科技股份有限公司
三菱商事株式会社	三菱商事株式会社
三菱汽车	三菱商事株式会社
深圳市纺织集团股份有限公司	深圳市纺织集团股份有限公司
深纺织A	深圳市纺织集团股份有限公司
洛阳玻璃股份有限公司	洛阳玻璃股份有限公司
洛阳玻璃	洛阳玻璃股份有限公司
和记黄埔有限公司	和记黄埔有限公司
和记黄埔	和记黄埔有限公司
中国辽宁国际合作集团股份有限公司	中国辽宁国际合作集团股份有限公司
\\*ST中辽	中国辽宁国际合作集团股份有限公司
营口港务股份有限公司	营口港务股份有限公司
营口港	营口港务股份有限公司
上海申华控股股份有限公司	上海申华控股股份有限公司
申华控股	上海申华控股股份有限公司
桂林广陆数字测控股份有限公司	桂林广陆数字测控股份有限公司
广陆数测	桂林广陆数字测控股份有限公司
嘉凯城集团股份有限公司	嘉凯城集团股份有限公司
嘉凯城	嘉凯城集团股份有限公司
中国人民人寿保险股份有限公司	中国人民人寿保险股份有限公司
人保寿险	中国人民人寿保险股份有限公司
东方电子股份有限公司	东方电子股份有限公司
东方电子	东方电子股份有限公司
云南网	云南网
云南网	云南网
上海广电集团有限公司	上海广电集团有限公司
上海广电	上海广电集团有限公司
青岛啤酒股份有限公司	青岛啤酒股份有限公司
青岛啤酒	青岛啤酒股份有限公司
江苏常宝钢管股份有限公司	江苏常宝钢管股份有限公司
常宝股份	江苏常宝钢管股份有限公司
侨兴集团	侨兴集团
侨兴集团	侨兴集团
上海同达创业投资股份有限公司	上海同达创业投资股份有限公司
同达创业	上海同达创业投资股份有限公司
安徽四创电子股份有限公司	安徽四创电子股份有限公司
四创电子	安徽四创电子股份有限公司
骆驼集团股份有限公司	骆驼集团股份有限公司
骆驼股份	骆驼集团股份有限公司
南方风机股份有限公司	南方风机股份有限公司
南风股份.*南方风机	南方风机股份有限公司
上海宝信软件股份有限公司	上海宝信软件股份有限公司
宝信软件	上海宝信软件股份有限公司
绿城集团	绿城集团
绿城集团	绿城集团
河南天方药业股份有限公司	河南天方药业股份有限公司
天方药业.*\\*ST天方	河南天方药业股份有限公司
尚德太阳能电力有限公司	尚德太阳能电力有限公司
无锡尚德	尚德太阳能电力有限公司
中国文化报	中国文化报
中国文化报	中国文化报
黑龙江国中水务股份有限公司	黑龙江国中水务股份有限公司
国中水务	黑龙江国中水务股份有限公司
中国五矿集团公司	中国五矿集团公司
五矿集团	中国五矿集团公司
武汉凡谷电子技术股份有限公司	武汉凡谷电子技术股份有限公司
武汉凡谷	武汉凡谷电子技术股份有限公司
韩国斗山集团	韩国斗山集团
斗山集团	韩国斗山集团
广州广日股份有限公司	广州广日股份有限公司
广日股份	广州广日股份有限公司
深圳达实智能股份有限公司	深圳达实智能股份有限公司
达实智能	深圳达实智能股份有限公司
中国长江电力股份有限公司	中国长江电力股份有限公司
长江电力	中国长江电力股份有限公司
国泰君安证券有限公司	国泰君安证券有限公司
国泰君安	国泰君安证券有限公司
深圳大通实业股份有限公司	深圳大通实业股份有限公司
深大通	深圳大通实业股份有限公司
南京高科股份有限公司	南京高科股份有限公司
南京高科	南京高科股份有限公司
莱茵达置业股份有限公司	莱茵达置业股份有限公司
莱茵置业	莱茵达置业股份有限公司
浙江森桥实业集团有限公司	浙江森桥实业集团有限公司
森桥实业	浙江森桥实业集团有限公司
南京新街口百货商店股份有限公司	南京新街口百货商店股份有限公司
南京新百	南京新街口百货商店股份有限公司
广州铁路（集团）公司	广州铁路（集团）公司
广铁集团	广州铁路（集团）公司
安阳钢铁集团有限责任公司	安阳钢铁集团有限责任公司
安钢集团	安阳钢铁集团有限责任公司
陕西省国际信托股份有限公司	陕西省国际信托股份有限公司
陕国投.*陕国投A.*陕国投Ａ	陕西省国际信托股份有限公司
珠海市乐通化工股份有限公司	珠海市乐通化工股份有限公司
乐通股份	珠海市乐通化工股份有限公司
上海海隆软件股份有限公司	上海海隆软件股份有限公司
海隆软件	上海海隆软件股份有限公司
银江股份有限公司	银江股份有限公司
银江股份	银江股份有限公司
沈阳蓝英工业自动化装备股份有限公司	沈阳蓝英工业自动化装备股份有限公司
蓝英装备	沈阳蓝英工业自动化装备股份有限公司
昆山新莱洁净应用材料股份有限公司	昆山新莱洁净应用材料股份有限公司
新莱应材	昆山新莱洁净应用材料股份有限公司
北京北信源软件股份有限公司	北京北信源软件股份有限公司
北信源	北京北信源软件股份有限公司
中电广通股份有限公司	中电广通股份有限公司
中电广通	中电广通股份有限公司
爱尔眼科医院集团股份有限公司	爱尔眼科医院集团股份有限公司
爱尔眼科	爱尔眼科医院集团股份有限公司
江苏丰东热技术股份有限公司	江苏丰东热技术股份有限公司
丰东股份	江苏丰东热技术股份有限公司
东方集团股份有限公司	东方集团股份有限公司
东方集团	东方集团股份有限公司
上海飞乐股份有限公司	上海飞乐股份有限公司
飞乐股份	上海飞乐股份有限公司
深圳雷曼光电科技股份有限公司	深圳雷曼光电科技股份有限公司
雷曼光电	深圳雷曼光电科技股份有限公司
大庆华科股份有限公司	大庆华科股份有限公司
大庆华科	大庆华科股份有限公司
东方电气股份有限公司	东方电气股份有限公司
东方电气	东方电气股份有限公司
湖北省广播电视信息网络股份有限公司	湖北省广播电视信息网络股份有限公司
湖北广电	湖北省广播电视信息网络股份有限公司
今典投资集团有限公司	今典投资集团有限公司
今典集团	今典投资集团有限公司
云南机场集团有限责任公司	云南机场集团有限责任公司
云南机场	云南机场集团有限责任公司
思美传媒股份有限公司	思美传媒股份有限公司
思美传媒	思美传媒股份有限公司
河南黄河旋风股份有限公司	河南黄河旋风股份有限公司
黄河旋风	河南黄河旋风股份有限公司
浙江新湖创业投资股份有限公司	浙江新湖创业投资股份有限公司
新湖创业	浙江新湖创业投资股份有限公司
广东超华科技股份有限公司	广东超华科技股份有限公司
超华科技	广东超华科技股份有限公司
中关村在线	中关村在线
中关村在线	中关村在线
中粮新疆屯河股份有限公司	中粮新疆屯河股份有限公司
中粮屯河	中粮新疆屯河股份有限公司
天津钢管集团股份有限公司	天津钢管集团股份有限公司
天津钢管	天津钢管集团股份有限公司
连云港传媒网	连云港传媒网
连云港传媒网	连云港传媒网
深圳海联讯科技股份有限公司	深圳海联讯科技股份有限公司
海联讯	深圳海联讯科技股份有限公司
上海百联集团股份有限公司	上海百联集团股份有限公司
百联股份	上海百联集团股份有限公司
麦可思人力资源信息管理咨询有限公司	麦可思人力资源信息管理咨询有限公司
麦可思	麦可思人力资源信息管理咨询有限公司
山东新北洋信息技术股份有限公司	山东新北洋信息技术股份有限公司
新北洋	山东新北洋信息技术股份有限公司
奇正集团	奇正集团
奇正集团	奇正集团
中国建设报	中国建设报
中国建设报	中国建设报
江苏常发制冷股份有限公司	江苏常发制冷股份有限公司
常发股份	江苏常发制冷股份有限公司
日本KDDI电信公司	日本KDDI电信公司
KDDI	日本KDDI电信公司
浙江京新药业股份有限公司	浙江京新药业股份有限公司
京新药业	浙江京新药业股份有限公司
六安新闻网	六安新闻网
六安新闻网	六安新闻网
宁波富邦精业集团股份有限公司	宁波富邦精业集团股份有限公司
宁波富邦	宁波富邦精业集团股份有限公司
北京同有飞骥科技股份有限公司	北京同有飞骥科技股份有限公司
同有科技	北京同有飞骥科技股份有限公司
郑州金惠计算机系统工程有限公司	郑州金惠计算机系统工程有限公司
郑州金惠	郑州金惠计算机系统工程有限公司
深圳光韵达光电科技股份有限公司	深圳光韵达光电科技股份有限公司
光韵达	深圳光韵达光电科技股份有限公司
国投电力控股股份有限公司	国投电力控股股份有限公司
国投电力	国投电力控股股份有限公司
天津市房地产发展(集团)股份有限公司	天津市房地产发展(集团)股份有限公司
天房发展	天津市房地产发展(集团)股份有限公司
南京科远自动化集团股份有限公司	南京科远自动化集团股份有限公司
科远股份	南京科远自动化集团股份有限公司
大冶特殊钢股份有限公司	大冶特殊钢股份有限公司
大冶特钢	大冶特殊钢股份有限公司
常州星宇车灯股份有限公司	常州星宇车灯股份有限公司
星宇股份	常州星宇车灯股份有限公司
深圳市锐拓灯饰照明有限公司	深圳市锐拓灯饰照明有限公司
深圳锐拓	深圳市锐拓灯饰照明有限公司
美国克罗格公司	美国克罗格公司
克罗格	美国克罗格公司
韩亚银行	韩亚银行
韩亚银行	韩亚银行
湛江国联水产开发股份有限公司	湛江国联水产开发股份有限公司
国联水产	湛江国联水产开发股份有限公司
艾默生电气集团	艾默生电气集团
艾默生电气	艾默生电气集团
重庆医药股份有限公司	重庆医药股份有限公司
重庆医药	重庆医药股份有限公司
广州市鸿利光电股份有限公司	广州市鸿利光电股份有限公司
鸿利光电	广州市鸿利光电股份有限公司
慧聪网有限公司	慧聪网有限公司
慧聪网	慧聪网有限公司
上海莱士血液制品股份有限公司	上海莱士血液制品股份有限公司
上海莱士	上海莱士血液制品股份有限公司
广东东方锆业科技股份有限公司	广东东方锆业科技股份有限公司
东方锆业	广东东方锆业科技股份有限公司
上海国嘉实业股份有限公司	上海国嘉实业股份有限公司
国嘉实业	上海国嘉实业股份有限公司
天士力制药集团股份有限公司	天士力制药集团股份有限公司
天士力	天士力制药集团股份有限公司
山东金岭集团有限公司	山东金岭集团有限公司
山东金岭	山东金岭集团有限公司
恒隆地产有限公司	恒隆地产有限公司
恒隆地产	恒隆地产有限公司
苏州工业园区建屋发展集团有限公司	苏州工业园区建屋发展集团有限公司
建屋集团	苏州工业园区建屋发展集团有限公司
上海亚通股份有限公司	上海亚通股份有限公司
亚通股份	上海亚通股份有限公司
富通集团	富通集团
富通集团	富通集团
广州颐和集团有限公司	广州颐和集团有限公司
颐和集团	广州颐和集团有限公司
江苏通鼎光电股份有限公司	江苏通鼎光电股份有限公司
通鼎光电	江苏通鼎光电股份有限公司
雀巢集团	雀巢集团
雀巢	雀巢集团
华人置业集团有限公司	华人置业集团有限公司
华人置业	华人置业集团有限公司
伦敦金属交易所	伦敦金属交易所
伦敦金属交易所	伦敦金属交易所
燕赵都市报	燕赵都市报
燕赵都市报	燕赵都市报
上海国际港务集团股份有限公司	上海国际港务集团股份有限公司
上港集团	上海国际港务集团股份有限公司
南方宇航科技股份有限公司	南方宇航科技股份有限公司
ST宇航	南方宇航科技股份有限公司
苏黎世金融服务集团	苏黎世金融服务集团
苏黎世金融	苏黎世金融服务集团
成都红旗连锁股份有限公司	成都红旗连锁股份有限公司
红旗连锁	成都红旗连锁股份有限公司
镇江江南化工有限公司	镇江江南化工有限公司
江南化工	镇江江南化工有限公司
喜临门家具股份有限公司	喜临门家具股份有限公司
喜临门	喜临门家具股份有限公司
辽宁红阳能源投资股份有限公司	辽宁红阳能源投资股份有限公司
红阳能源	辽宁红阳能源投资股份有限公司
路桥集团国际建设股份有限公司	路桥集团国际建设股份有限公司
路桥建设	路桥集团国际建设股份有限公司
吉林银行股份有限公司	吉林银行股份有限公司
吉林银行	吉林银行股份有限公司
云南国际信托有限公司	云南国际信托有限公司
云南国投	云南国际信托有限公司
湖南电广传媒股份有限公司	湖南电广传媒股份有限公司
电广传媒	湖南电广传媒股份有限公司
杭州市商业银行	杭州市商业银行
杭州市商业银行	杭州市商业银行
广东太安堂药业股份有限公司	广东太安堂药业股份有限公司
太安堂	广东太安堂药业股份有限公司
长江养老保险股份有限公司	长江养老保险股份有限公司
长江养老险	长江养老保险股份有限公司
江铃汽车股份有限公司	江铃汽车股份有限公司
江铃汽车	江铃汽车股份有限公司
万马集团	万马集团
万马集团	万马集团
cnstock	cnstock
中国证券网	cnstock
江苏林洋电子股份有限公司	江苏林洋电子股份有限公司
林洋电子	江苏林洋电子股份有限公司
天津市物资集团总公司	天津市物资集团总公司
天津市物资集团	天津市物资集团总公司
北方国际合作股份有限公司	北方国际合作股份有限公司
北方国际	北方国际合作股份有限公司
四川雅化实业集团股份有限公司	四川雅化实业集团股份有限公司
雅化集团	四川雅化实业集团股份有限公司
北京燕京啤酒股份有限公司	北京燕京啤酒股份有限公司
燕京啤酒	北京燕京啤酒股份有限公司
华联控股股份有限公司	华联控股股份有限公司
华联控股	华联控股股份有限公司
华闻传媒投资集团股份有限公司	华闻传媒投资集团股份有限公司
华闻传媒	华闻传媒投资集团股份有限公司
中国宝龙电子集团公司	中国宝龙电子集团公司
宝龙集团	中国宝龙电子集团公司
成都飞机工业公司	成都飞机工业公司
成都飞机工业公司	成都飞机工业公司
格兰仕集团	格兰仕集团
格兰仕	格兰仕集团
北京市天元网络技术股份有限公司	北京市天元网络技术股份有限公司
天元网络	北京市天元网络技术股份有限公司
深圳市大富科技股份有限公司	深圳市大富科技股份有限公司
大富科技	深圳市大富科技股份有限公司
广西玉柴机器集团有限公司	广西玉柴机器集团有限公司
玉柴集团	广西玉柴机器集团有限公司
岭南园林股份有限公司	岭南园林股份有限公司
岭南园林	岭南园林股份有限公司
中国海诚工程科技股份有限公司	中国海诚工程科技股份有限公司
中国海诚	中国海诚工程科技股份有限公司
大连华锐重工集团股份有限公司	大连华锐重工集团股份有限公司
大连重工	大连华锐重工集团股份有限公司
黑龙江天伦置业股份有限公司	黑龙江天伦置业股份有限公司
天伦置业	黑龙江天伦置业股份有限公司
晨兴创投	晨兴创投
晨兴创投	晨兴创投
福建闽越花雕股份有限公司	福建闽越花雕股份有限公司
闽越花雕	福建闽越花雕股份有限公司
瞭望东方周刊	瞭望东方周刊
瞭望	瞭望东方周刊
山东阳谷华泰化工股份有限公司	山东阳谷华泰化工股份有限公司
阳谷华泰	山东阳谷华泰化工股份有限公司
新乡化纤股份有限公司	新乡化纤股份有限公司
新乡化纤	新乡化纤股份有限公司
四川金路集团股份有限公司	四川金路集团股份有限公司
金路集团	四川金路集团股份有限公司
福建水泥股份有限公司	福建水泥股份有限公司
福建水泥	福建水泥股份有限公司
金安国纪科技股份有限公司	金安国纪科技股份有限公司
金安国纪	金安国纪科技股份有限公司
华天酒店集团股份有限公司	华天酒店集团股份有限公司
华天酒店	华天酒店集团股份有限公司
北京巴士传媒股份有限公司	北京巴士传媒股份有限公司
北巴传媒	北京巴士传媒股份有限公司
班尼路集团有限公司	班尼路集团有限公司
班尼路	班尼路集团有限公司
福建省南纸股份有限公司	福建省南纸股份有限公司
福建南纸	福建省南纸股份有限公司
安徽江南化工股份有限公司	安徽江南化工股份有限公司
江南化工	安徽江南化工股份有限公司
新疆伊力特实业股份有限公司	新疆伊力特实业股份有限公司
伊力特	新疆伊力特实业股份有限公司
中华人民共和国国家外汇管理局网	中华人民共和国国家外汇管理局网
国家外汇管理局网	中华人民共和国国家外汇管理局网
陕西炼石有色资源股份有限公司	陕西炼石有色资源股份有限公司
炼石有色	陕西炼石有色资源股份有限公司
中华网科技公司	中华网科技公司
中华网	中华网科技公司
深圳赤湾石油基地股份有限公司	深圳赤湾石油基地股份有限公司
深基地.*深基地Ｂ	深圳赤湾石油基地股份有限公司
天顺风能(苏州)股份有限公司	天顺风能(苏州)股份有限公司
天顺风能	天顺风能(苏州)股份有限公司
湖南新五丰股份有限公司	湖南新五丰股份有限公司
新五丰	湖南新五丰股份有限公司
华安证券有限责任公司	华安证券有限责任公司
华安证券	华安证券有限责任公司
江西省冶金集团公司	江西省冶金集团公司
江西冶金	江西省冶金集团公司
苏州宝馨科技实业股份有限公司	苏州宝馨科技实业股份有限公司
宝馨科技	苏州宝馨科技实业股份有限公司
厦门信达股份有限公司	厦门信达股份有限公司
厦门信达	厦门信达股份有限公司
上海浦东发展银行股份有限公司	上海浦东发展银行股份有限公司
浦发银行	上海浦东发展银行股份有限公司
中德安联人寿保险有限公司	中德安联人寿保险有限公司
中德安联人寿	中德安联人寿保险有限公司
河北天山房地产开发有限公司	河北天山房地产开发有限公司
天山地产	河北天山房地产开发有限公司
广东天龙油墨集团股份有限公司	广东天龙油墨集团股份有限公司
天龙集团	广东天龙油墨集团股份有限公司
日本生命保险公司	日本生命保险公司
日本生命	日本生命保险公司
罗顿发展股份有限公司	罗顿发展股份有限公司
罗顿发展	罗顿发展股份有限公司
浙江艾迪西流体控制股份有限公司	浙江艾迪西流体控制股份有限公司
艾迪西	浙江艾迪西流体控制股份有限公司
北京众信国际旅行社股份有限公司	北京众信国际旅行社股份有限公司
众信旅游	北京众信国际旅行社股份有限公司
武汉天喻信息产业股份有限公司	武汉天喻信息产业股份有限公司
天喻信息	武汉天喻信息产业股份有限公司
东北证券股份有限公司	东北证券股份有限公司
东北证券	东北证券股份有限公司
深圳市聚飞光电股份有限公司	深圳市聚飞光电股份有限公司
聚飞光电	深圳市聚飞光电股份有限公司
烟台园城黄金股份有限公司	烟台园城黄金股份有限公司
园城黄金	烟台园城黄金股份有限公司
中国西电电气股份有限公司	中国西电电气股份有限公司
中国西电	中国西电电气股份有限公司
中铁大桥局集团有限公司	中铁大桥局集团有限公司
中铁大桥局	中铁大桥局集团有限公司
北京金玉翠福珠宝有限公司	北京金玉翠福珠宝有限公司
金玉翠福	北京金玉翠福珠宝有限公司
新疆北新路桥集团股份有限公司	新疆北新路桥集团股份有限公司
北新路桥	新疆北新路桥集团股份有限公司
四川剑南春集团有限责任公司	四川剑南春集团有限责任公司
剑南春	四川剑南春集团有限责任公司
浙江亿利达风机有限公司	浙江亿利达风机有限公司
亿利达风机	浙江亿利达风机有限公司
苏州禾盛新型材料股份有限公司	苏州禾盛新型材料股份有限公司
禾盛新材	苏州禾盛新型材料股份有限公司
北京市金寿典当有限责任公司	北京市金寿典当有限责任公司
金寿典当	北京市金寿典当有限责任公司
中国汽车工程研究院股份有限公司	中国汽车工程研究院股份有限公司
中国汽研	中国汽车工程研究院股份有限公司
维科控股集团股份有限公司	维科控股集团股份有限公司
维科集团	维科控股集团股份有限公司
宁波天邦股份有限公司	宁波天邦股份有限公司
天邦股份	宁波天邦股份有限公司
鸿海精密集团	鸿海精密集团
鸿海精密	鸿海精密集团
河北金牛化工股份有限公司	河北金牛化工股份有限公司
金牛化工.*ST金化	河北金牛化工股份有限公司
威海华东数控股份有限公司	威海华东数控股份有限公司
华东数控	威海华东数控股份有限公司
上海耀华皮尔金顿玻璃股份有限公司	上海耀华皮尔金顿玻璃股份有限公司
耀皮玻璃	上海耀华皮尔金顿玻璃股份有限公司
江苏沙钢股份有限公司	江苏沙钢股份有限公司
沙钢股份	江苏沙钢股份有限公司
上海物资贸易股份有限公司	上海物资贸易股份有限公司
上海物贸	上海物资贸易股份有限公司
中国中期投资股份有限公司	中国中期投资股份有限公司
中国中期	中国中期投资股份有限公司
江苏澳洋顺昌股份有限公司	江苏澳洋顺昌股份有限公司
澳洋顺昌	江苏澳洋顺昌股份有限公司
深圳市麦捷微电子科技股份有限公司	深圳市麦捷微电子科技股份有限公司
麦捷科技	深圳市麦捷微电子科技股份有限公司
浙江嘉欣丝绸股份有限公司	浙江嘉欣丝绸股份有限公司
嘉欣丝绸	浙江嘉欣丝绸股份有限公司
福建浔兴拉链科技股份有限公司	福建浔兴拉链科技股份有限公司
浔兴股份	福建浔兴拉链科技股份有限公司
哈尔滨东安汽车动力股份有限公司	哈尔滨东安汽车动力股份有限公司
东安动力	哈尔滨东安汽车动力股份有限公司
华润深国投信托有限公司	华润深国投信托有限公司
深国投	华润深国投信托有限公司
中国菏泽网	中国菏泽网
中国菏泽网	中国菏泽网
金陵饭店股份有限公司	金陵饭店股份有限公司
金陵饭店	金陵饭店股份有限公司
安徽安科生物工程（集团）股份有限公司	安徽安科生物工程（集团）股份有限公司
安科生物	安徽安科生物工程（集团）股份有限公司
深圳市奋达科技股份有限公司	深圳市奋达科技股份有限公司
奋达科技	深圳市奋达科技股份有限公司
福建星网锐捷通讯股份有限公司	福建星网锐捷通讯股份有限公司
星网锐捷	福建星网锐捷通讯股份有限公司
四川富临运业集团股份有限公司	四川富临运业集团股份有限公司
富临运业	四川富临运业集团股份有限公司
紫金矿业集团股份有限公司	紫金矿业集团股份有限公司
紫金矿业	紫金矿业集团股份有限公司
湛江市商业银行	湛江市商业银行
湛江市商业银行	湛江市商业银行
博深工具股份有限公司	博深工具股份有限公司
博深工具	博深工具股份有限公司
山西证券有限责任公司	山西证券有限责任公司
山西证券	山西证券有限责任公司
鹏华基金管理有限公司	鹏华基金管理有限公司
鹏华基金	鹏华基金管理有限公司
四川仁智油田技术服务股份有限公司	四川仁智油田技术服务股份有限公司
仁智油服	四川仁智油田技术服务股份有限公司
陕西兴化化学股份有限公司	陕西兴化化学股份有限公司
兴化股份	陕西兴化化学股份有限公司
芝加哥商品交易所	芝加哥商品交易所
芝加哥商品交易所	芝加哥商品交易所
意大利联合信贷银行	意大利联合信贷银行
联合信贷银行	意大利联合信贷银行
北方网	北方网
北方网	北方网
山西同德化工股份有限公司	山西同德化工股份有限公司
同德化工	山西同德化工股份有限公司
汕头万顺包装材料股份有限公司	汕头万顺包装材料股份有限公司
万顺股份	汕头万顺包装材料股份有限公司
吉林通海高科技股份有限公司	吉林通海高科技股份有限公司
通海高科	吉林通海高科技股份有限公司
南京中北集团股份有限公司	南京中北集团股份有限公司
南京中北	南京中北集团股份有限公司
丽江玉龙旅游股份有限公司	丽江玉龙旅游股份有限公司
丽江旅游	丽江玉龙旅游股份有限公司
步步高商业连锁股份有限公司	步步高商业连锁股份有限公司
步步高	步步高商业连锁股份有限公司
上海海鸟企业发展股份有限公司	上海海鸟企业发展股份有限公司
海鸟发展	上海海鸟企业发展股份有限公司
兰州兰石炼化设备公司	兰州兰石炼化设备公司
兰州兰石	兰州兰石炼化设备公司
广东金刚玻璃科技股份有限公司	广东金刚玻璃科技股份有限公司
金刚玻璃	广东金刚玻璃科技股份有限公司
浙江禾欣实业集团股份有限公司	浙江禾欣实业集团股份有限公司
禾欣股份	浙江禾欣实业集团股份有限公司
新营销	新营销
新营销	新营销
申银万国证券股份有限公司	申银万国证券股份有限公司
申银万国	申银万国证券股份有限公司
惠州亿纬锂能股份有限公司	惠州亿纬锂能股份有限公司
亿纬锂能	惠州亿纬锂能股份有限公司
芜湖顺荣汽车部件股份有限公司	芜湖顺荣汽车部件股份有限公司
顺荣股份	芜湖顺荣汽车部件股份有限公司
上海交大昂立股份有限公司	上海交大昂立股份有限公司
交大昂立	上海交大昂立股份有限公司
dongfangzaobao	dongfangzaobao
东方早报	dongfangzaobao
浙江海越股份有限公司	浙江海越股份有限公司
海越股份	浙江海越股份有限公司
上海联华合纤股份有限公司	上海联华合纤股份有限公司
联华合纤	上海联华合纤股份有限公司
青岛亚东橡机有限公司	青岛亚东橡机有限公司
亚东橡机	青岛亚东橡机有限公司
财新传媒	财新传媒
财新传媒	财新传媒
日本新日矿集团	日本新日矿集团
新日矿	日本新日矿集团
招商证券股份有限公司	招商证券股份有限公司
招商证券	招商证券股份有限公司
北京城建兴华地产有限公司	北京城建兴华地产有限公司
城建兴华	北京城建兴华地产有限公司
艾格菲国际集团公司	艾格菲国际集团公司
艾格菲	艾格菲国际集团公司
投资者报	投资者报
投资者报	投资者报
上海强生控股股份有限公司	上海强生控股股份有限公司
强生控股	上海强生控股股份有限公司
深圳能源集团股份有限公司	深圳能源集团股份有限公司
深圳能源	深圳能源集团股份有限公司
甘肃省敦煌种业股份有限公司	甘肃省敦煌种业股份有限公司
敦煌种业	甘肃省敦煌种业股份有限公司
云南博闻科技实业股份有限公司	云南博闻科技实业股份有限公司
博闻科技	云南博闻科技实业股份有限公司
当代经理人	当代经理人
当代经理人	当代经理人
山西证券股份有限公司	山西证券股份有限公司
山西证券	山西证券股份有限公司
昆明百货大楼集团股份有限公司	昆明百货大楼集团股份有限公司
昆百大A	昆明百货大楼集团股份有限公司
惠州市华阳集团有限公司	惠州市华阳集团有限公司
华阳集团	惠州市华阳集团有限公司
深圳市天地(集团)股份有限公司	深圳市天地(集团)股份有限公司
深天地.*深天地Ａ	深圳市天地(集团)股份有限公司
北京绵世投资集团股份有限公司	北京绵世投资集团股份有限公司
绵世股份	北京绵世投资集团股份有限公司
重庆三峡油漆股份有限公司	重庆三峡油漆股份有限公司
渝三峡.*渝三峡A.*渝三峡Ａ	重庆三峡油漆股份有限公司
印度斯坦石油公司	印度斯坦石油公司
印度斯坦石油	印度斯坦石油公司
山东美晨科技股份有限公司	山东美晨科技股份有限公司
美晨科技	山东美晨科技股份有限公司
软控股份有限公司	软控股份有限公司
软控股份	软控股份有限公司
江西省电子集团公司	江西省电子集团公司
江西电子	江西省电子集团公司
德阳市商业银行	德阳市商业银行
德阳市商业银行	德阳市商业银行
四川郎酒集团有限责任公司	四川郎酒集团有限责任公司
郎酒集团	四川郎酒集团有限责任公司
北京博晖创新光电技术股份有限公司	北京博晖创新光电技术股份有限公司
博晖创新	北京博晖创新光电技术股份有限公司
方正证券股份有限公司	方正证券股份有限公司
方正证券	方正证券股份有限公司
北京威卡威汽车零部件股份有限公司	北京威卡威汽车零部件股份有限公司
京威股份	北京威卡威汽车零部件股份有限公司
羊城晚报	羊城晚报
羊城晚报	羊城晚报
巨轮股份有限公司	巨轮股份有限公司
巨轮股份	巨轮股份有限公司
宜华地产股份有限公司	宜华地产股份有限公司
宜华地产	宜华地产股份有限公司
英国巴克莱银行	英国巴克莱银行
巴克莱	英国巴克莱银行
上海置信电气股份有限公司	上海置信电气股份有限公司
置信电气	上海置信电气股份有限公司
光正集团股份有限公司	光正集团股份有限公司
光正集团	光正集团股份有限公司
中国冶金报	中国冶金报
中国冶金报	中国冶金报
中房地产股份有限公司	中房地产股份有限公司
中房地产	中房地产股份有限公司
长盛基金管理有限公司	长盛基金管理有限公司
长盛基金	长盛基金管理有限公司
深圳和而泰智能控制股份有限公司	深圳和而泰智能控制股份有限公司
和而泰	深圳和而泰智能控制股份有限公司
上海汉得信息技术股份有限公司	上海汉得信息技术股份有限公司
汉得信息	上海汉得信息技术股份有限公司
二六三网络通信股份有限公司	二六三网络通信股份有限公司
二六三	二六三网络通信股份有限公司
江苏银河电子股份有限公司	江苏银河电子股份有限公司
银河电子	江苏银河电子股份有限公司
常州天晟新材料股份有限公司	常州天晟新材料股份有限公司
天晟新材	常州天晟新材料股份有限公司
江苏双星彩塑新材料股份有限公司	江苏双星彩塑新材料股份有限公司
双星新材	江苏双星彩塑新材料股份有限公司
北京宏怀房地产开发公司	北京宏怀房地产开发公司
宏怀地产	北京宏怀房地产开发公司
鼎捷软件股份有限公司	鼎捷软件股份有限公司
鼎捷软件	鼎捷软件股份有限公司
深圳新宙邦科技股份有限公司	深圳新宙邦科技股份有限公司
新宙邦	深圳新宙邦科技股份有限公司
索芙特股份有限公司	索芙特股份有限公司
索芙特	索芙特股份有限公司
金元比联基金管理有限公司	金元比联基金管理有限公司
金元比联基金	金元比联基金管理有限公司
倍立达集团	倍立达集团
倍立达	倍立达集团
湖北稻花香集团	湖北稻花香集团
稻花香	湖北稻花香集团
英特尔公司	英特尔公司
英特尔	英特尔公司
国家电网公司	国家电网公司
国家电网	国家电网公司
兰州海默科技股份有限公司	兰州海默科技股份有限公司
海默科技	兰州海默科技股份有限公司
中工国际工程股份有限公司	中工国际工程股份有限公司
中工国际	中工国际工程股份有限公司
江苏东源电器集团股份有限公司	江苏东源电器集团股份有限公司
东源电器	江苏东源电器集团股份有限公司
上海爱建股份有限公司	上海爱建股份有限公司
爱建股份	上海爱建股份有限公司
深圳市农产品股份有限公司	深圳市农产品股份有限公司
农产品	深圳市农产品股份有限公司
中航投资控股股份有限公司	中航投资控股股份有限公司
中航投资	中航投资控股股份有限公司
中国科健股份有限公司	中国科健股份有限公司
中科健.*ST科健.*\\*ST科健	中国科健股份有限公司
云南文山电力股份有限公司	云南文山电力股份有限公司
文山电力	云南文山电力股份有限公司
北京市农村商业银行	北京市农村商业银行
北京农商行	北京市农村商业银行
奥亮集团有限公司	奥亮集团有限公司
奥亮集团	奥亮集团有限公司
美国友邦保险有限公司	美国友邦保险有限公司
友邦保险集团	美国友邦保险有限公司
McDonald's	McDonald's
麦当劳	McDonald's
山东民和牧业股份有限公司	山东民和牧业股份有限公司
民和股份	山东民和牧业股份有限公司
新华通讯社	新华通讯社
新华社	新华通讯社
北京昊华能源股份有限公司	北京昊华能源股份有限公司
昊华能源	北京昊华能源股份有限公司
深圳市远望谷信息技术股份有限公司	深圳市远望谷信息技术股份有限公司
远望谷	深圳市远望谷信息技术股份有限公司
中国湖南电视台	中国湖南电视台
湖南卫视	中国湖南电视台
银河基金管理有限公司	银河基金管理有限公司
银河基金	银河基金管理有限公司
华纺股份有限公司	华纺股份有限公司
华纺股份	华纺股份有限公司
湖北金环股份有限公司	湖北金环股份有限公司
湖北金环	湖北金环股份有限公司
贵州久联民爆器材发展股份有限公司	贵州久联民爆器材发展股份有限公司
久联发展	贵州久联民爆器材发展股份有限公司
江苏长海复合材料股份有限公司	江苏长海复合材料股份有限公司
长海股份	江苏长海复合材料股份有限公司
宝钢集团有限公司	宝钢集团有限公司
宝钢集团	宝钢集团有限公司
中茵股份有限公司	中茵股份有限公司
中茵股份	中茵股份有限公司
中国南方工业汽车股份有限公司	中国南方工业汽车股份有限公司
南方汽车	中国南方工业汽车股份有限公司
美国安利公司	美国安利公司
安利	美国安利公司
耐克公司	耐克公司
耐克	耐克公司
东港股份有限公司	东港股份有限公司
东港股份	东港股份有限公司
上海家化联合股份有限公司	上海家化联合股份有限公司
上海家化	上海家化联合股份有限公司
上海普天邮通科技股份有限公司	上海普天邮通科技股份有限公司
上海普天	上海普天邮通科技股份有限公司
中国光大房地产开发有限公司	中国光大房地产开发有限公司
光大房地产	中国光大房地产开发有限公司
汉王科技股份有限公司	汉王科技股份有限公司
汉王科技	汉王科技股份有限公司
重庆啤酒股份有限公司	重庆啤酒股份有限公司
重庆啤酒	重庆啤酒股份有限公司
长城电器集团	长城电器集团
长城电器	长城电器集团
上海九百股份有限公司	上海九百股份有限公司
上海九百	上海九百股份有限公司
武汉长江通信产业集团股份有限公司	武汉长江通信产业集团股份有限公司
长江通信	武汉长江通信产业集团股份有限公司
国投信托有限公司	国投信托有限公司
国投信托	国投信托有限公司
浙江传化集团	浙江传化集团
传化集团	浙江传化集团
恒逸石化股份有限公司	恒逸石化股份有限公司
恒逸石化	恒逸石化股份有限公司
三湘股份有限公司	三湘股份有限公司
三湘股份	三湘股份有限公司
美国利宝相互保险公司	美国利宝相互保险公司
利宝相互保险	美国利宝相互保险公司
上海城建集团公司	上海城建集团公司
上海城建	上海城建集团公司
民安保险中国有限公司	民安保险中国有限公司
民安保险	民安保险中国有限公司
上海大智慧股份有限公司	上海大智慧股份有限公司
大智慧	上海大智慧股份有限公司
中信万通证券有限责任公司	中信万通证券有限责任公司
中信万通	中信万通证券有限责任公司
浙江日发精密机械股份有限公司	浙江日发精密机械股份有限公司
日发精机	浙江日发精密机械股份有限公司
太原钢铁集团有限公司	太原钢铁集团有限公司
太原钢铁	太原钢铁集团有限公司
威海旭斌房地产开发有限公司	威海旭斌房地产开发有限公司
旭斌房地产	威海旭斌房地产开发有限公司
大庆联谊石化股份有限公司	大庆联谊石化股份有限公司
大庆联谊	大庆联谊石化股份有限公司
厦门三维丝环保股份有限公司	厦门三维丝环保股份有限公司
三维丝	厦门三维丝环保股份有限公司
陕西烽火电子股份有限公司	陕西烽火电子股份有限公司
烽火电子	陕西烽火电子股份有限公司
深圳珈伟光伏照明股份有限公司	深圳珈伟光伏照明股份有限公司
珈伟股份	深圳珈伟光伏照明股份有限公司
杭州泰格医药科技股份有限公司	杭州泰格医药科技股份有限公司
泰格医药	杭州泰格医药科技股份有限公司
浙江康盛股份有限公司	浙江康盛股份有限公司
康盛股份	浙江康盛股份有限公司
漳州片仔癀药业股份有限公司	漳州片仔癀药业股份有限公司
片仔癀	漳州片仔癀药业股份有限公司
朗讯科技公司	朗讯科技公司
朗讯	朗讯科技公司
北京利尔高温材料股份有限公司	北京利尔高温材料股份有限公司
北京利尔	北京利尔高温材料股份有限公司
恒丰银行股份有限公司	恒丰银行股份有限公司
恒丰银行	恒丰银行股份有限公司
华龙网	华龙网
华龙网	华龙网
北京北斗星通导航技术股份有限公司	北京北斗星通导航技术股份有限公司
北斗星通	北京北斗星通导航技术股份有限公司
哈飞航空工业股份有限公司	哈飞航空工业股份有限公司
哈飞股份	哈飞航空工业股份有限公司
深圳劲嘉彩印集团股份有限公司	深圳劲嘉彩印集团股份有限公司
劲嘉股份	深圳劲嘉彩印集团股份有限公司
华工科技产业股份有限公司	华工科技产业股份有限公司
华工科技	华工科技产业股份有限公司
北京拓尔思信息技术股份有限公司	北京拓尔思信息技术股份有限公司
拓尔思	北京拓尔思信息技术股份有限公司
泰禾集团股份有限公司	泰禾集团股份有限公司
泰禾集团	泰禾集团股份有限公司
首都机场集团	首都机场集团
首都机场	首都机场集团
深圳市特力集团股份有限公司	深圳市特力集团股份有限公司
特力A	深圳市特力集团股份有限公司
喜力	喜力
喜力	喜力
四川路桥建设股份有限公司	四川路桥建设股份有限公司
四川路桥	四川路桥建设股份有限公司
广州医药有限公司	广州医药有限公司
广州医药	广州医药有限公司
浙江哈尔斯真空器皿股份有限公司	浙江哈尔斯真空器皿股份有限公司
哈尔斯	浙江哈尔斯真空器皿股份有限公司
四川创意信息技术股份有限公司	四川创意信息技术股份有限公司
创意信息	四川创意信息技术股份有限公司
云南白药集团股份有限公司	云南白药集团股份有限公司
云南白药	云南白药集团股份有限公司
阳泉煤业（集团）有限责任公司	阳泉煤业（集团）有限责任公司
阳煤集团	阳泉煤业（集团）有限责任公司
珠海鑫光集团股份有限公司	珠海鑫光集团股份有限公司
有色鑫光	珠海鑫光集团股份有限公司
乐普(北京)医疗器械股份有限公司	乐普(北京)医疗器械股份有限公司
乐普医疗	乐普(北京)医疗器械股份有限公司
健康元药业集团股份有限公司	健康元药业集团股份有限公司
健康元	健康元药业集团股份有限公司
北京金马典当有限责任公司	北京金马典当有限责任公司
金马典当	北京金马典当有限责任公司
上海佳豪船舶工程设计股份有限公司	上海佳豪船舶工程设计股份有限公司
上海佳豪.*佳豪船舶	上海佳豪船舶工程设计股份有限公司
金融街控股股份有限公司	金融街控股股份有限公司
金融街	金融街控股股份有限公司
上海永利带业股份有限公司	上海永利带业股份有限公司
永利带业	上海永利带业股份有限公司
中国服装股份有限公司	中国服装股份有限公司
中国服装	中国服装股份有限公司
中投信托有限责任公司	中投信托有限责任公司
中投信托	中投信托有限责任公司
美罗药业股份有限公司	美罗药业股份有限公司
美罗药业	美罗药业股份有限公司
恒天海龙股份有限公司	恒天海龙股份有限公司
恒天海龙	恒天海龙股份有限公司
沈阳鼓风机集团有限公司	沈阳鼓风机集团有限公司
沈阳鼓风机	沈阳鼓风机集团有限公司
江苏金智科技股份有限公司	江苏金智科技股份有限公司
金智科技	江苏金智科技股份有限公司
罗莱	罗莱
罗莱	罗莱
深圳市拓日新能源科技股份有限公司	深圳市拓日新能源科技股份有限公司
拓日新能	深圳市拓日新能源科技股份有限公司
新华都	新华都
新华都	新华都
重庆智飞生物制品股份有限公司	重庆智飞生物制品股份有限公司
智飞生物	重庆智飞生物制品股份有限公司
北国网	北国网
北国网	北国网
河南银鸽实业投资股份有限公司	河南银鸽实业投资股份有限公司
银鸽投资	河南银鸽实业投资股份有限公司
广州汇集实业股份有限公司	广州汇集实业股份有限公司
汇集实业	广州汇集实业股份有限公司
北京王府井百货(集团)股份有限公司	北京王府井百货(集团)股份有限公司
王府井	北京王府井百货(集团)股份有限公司
江苏亚太轻合金科技股份有限公司	江苏亚太轻合金科技股份有限公司
亚太科技	江苏亚太轻合金科技股份有限公司
广西北生药业股份有限公司	广西北生药业股份有限公司
北生药业.*\\*ST北生	广西北生药业股份有限公司
茂名石化实华股份有限公司	茂名石化实华股份有限公司
茂化实华	茂名石化实华股份有限公司
太原理工天成科技股份有限公司	太原理工天成科技股份有限公司
太工天成	太原理工天成科技股份有限公司
雅戈尔集团股份有限公司	雅戈尔集团股份有限公司
雅戈尔	雅戈尔集团股份有限公司
西安西港房地产开发集团有限公司	西安西港房地产开发集团有限公司
西港房地产	西安西港房地产开发集团有限公司
山西新闻网	山西新闻网
山西新闻网	山西新闻网
北京中长石基信息技术股份有限公司	北京中长石基信息技术股份有限公司
石基信息	北京中长石基信息技术股份有限公司
金龙机电股份有限公司	金龙机电股份有限公司
金龙机电	金龙机电股份有限公司
河南华英农业发展股份有限公司	河南华英农业发展股份有限公司
华英农业	河南华英农业发展股份有限公司
山东鲁抗医药股份有限公司	山东鲁抗医药股份有限公司
鲁抗医药	山东鲁抗医药股份有限公司
江苏中泰桥梁钢构股份有限公司	江苏中泰桥梁钢构股份有限公司
中泰桥梁	江苏中泰桥梁钢构股份有限公司
长城网	长城网
长城网	长城网
常熟风范电力设备股份有限公司	常熟风范电力设备股份有限公司
风范股份	常熟风范电力设备股份有限公司
恒泰证券股份有限公司	恒泰证券股份有限公司
恒泰证券	恒泰证券股份有限公司
中国光大银行股份有限公司	中国光大银行股份有限公司
光大银行	中国光大银行股份有限公司
金杯电工股份有限公司	金杯电工股份有限公司
金杯电工	金杯电工股份有限公司
深圳市洲明科技股份有限公司	深圳市洲明科技股份有限公司
洲明科技	深圳市洲明科技股份有限公司
包头明天科技股份有限公司	包头明天科技股份有限公司
明天科技	包头明天科技股份有限公司
法国工商信贷银行	法国工商信贷银行
工商信贷银行	法国工商信贷银行
江苏华盛天龙光电设备股份有限公司	江苏华盛天龙光电设备股份有限公司
天龙光电	江苏华盛天龙光电设备股份有限公司
华西能源工业股份有限公司	华西能源工业股份有限公司
华西能源	华西能源工业股份有限公司
福建海源自动化机械股份有限公司	福建海源自动化机械股份有限公司
海源机械	福建海源自动化机械股份有限公司
北京华力创通科技股份有限公司	北京华力创通科技股份有限公司
华力创通	北京华力创通科技股份有限公司
天津劝业场（集团）股份有限公司	天津劝业场（集团）股份有限公司
津劝业	天津劝业场（集团）股份有限公司
中航机载电子股份有限公司	中航机载电子股份有限公司
中航电子	中航机载电子股份有限公司
苏州恒久光电科技股份有限公司	苏州恒久光电科技股份有限公司
苏州恒久	苏州恒久光电科技股份有限公司
北京科锐配电自动化股份有限公司	北京科锐配电自动化股份有限公司
北京科锐	北京科锐配电自动化股份有限公司
内蒙古兰太实业股份有限公司	内蒙古兰太实业股份有限公司
兰太实业	内蒙古兰太实业股份有限公司
康力电梯股份有限公司	康力电梯股份有限公司
康力电梯	康力电梯股份有限公司
中国石油天然气集团公司	中国石油天然气集团公司
中国石油天然气	中国石油天然气集团公司
天津津滨发展股份有限公司	天津津滨发展股份有限公司
津滨发展.*天津津滨	天津津滨发展股份有限公司
北京长宜天地国际拍卖有限公司	北京长宜天地国际拍卖有限公司
长宜拍卖	北京长宜天地国际拍卖有限公司
江苏汇鸿股份有限公司	江苏汇鸿股份有限公司
汇鸿股份	江苏汇鸿股份有限公司
江西昌河汽车股份有限公司	江西昌河汽车股份有限公司
\\*ST昌河	江西昌河汽车股份有限公司
正和集团	正和集团
正和集团	正和集团
厦门市美亚柏科信息股份有限公司	厦门市美亚柏科信息股份有限公司
美亚柏科	厦门市美亚柏科信息股份有限公司
深圳莱宝高科技股份有限公司	深圳莱宝高科技股份有限公司
莱宝高科	深圳莱宝高科技股份有限公司
北京梅泰诺通信技术股份有限公司	北京梅泰诺通信技术股份有限公司
梅泰诺	北京梅泰诺通信技术股份有限公司
北京万邦达环保技术股份有限公司	北京万邦达环保技术股份有限公司
万邦达	北京万邦达环保技术股份有限公司
浙江海亮股份有限公司	浙江海亮股份有限公司
海亮股份	浙江海亮股份有限公司
中视传媒股份有限公司	中视传媒股份有限公司
中视传媒	中视传媒股份有限公司
贵人鸟股份有限公司	贵人鸟股份有限公司
贵人鸟	贵人鸟股份有限公司
江西铜业股份有限公司	江西铜业股份有限公司
江西铜业	江西铜业股份有限公司
Swarovski	Swarovski
施华洛世奇	Swarovski
上海张江高科技园区开发股份有限公司	上海张江高科技园区开发股份有限公司
张江高科	上海张江高科技园区开发股份有限公司
东莞发展控股股份有限公司	东莞发展控股股份有限公司
东莞控股	东莞发展控股股份有限公司
天信典当行	天信典当行
天信典当	天信典当行
青岛东方铁塔股份有限公司	青岛东方铁塔股份有限公司
东方铁塔	青岛东方铁塔股份有限公司
中国银行股份有限公司	中国银行股份有限公司
中国银行	中国银行股份有限公司
陕西建设机械股份有限公司	陕西建设机械股份有限公司
建设机械	陕西建设机械股份有限公司
天枝医疗投资管理集团	天枝医疗投资管理集团
天枝医疗	天枝医疗投资管理集团
首创安泰人寿保险有限公司	首创安泰人寿保险有限公司
首创安泰人寿	首创安泰人寿保险有限公司
上海期货交易所	上海期货交易所
上海期货交易所	上海期货交易所
江西特种电机股份有限公司	江西特种电机股份有限公司
江特电机	江西特种电机股份有限公司
马自达汽车公司	马自达汽车公司
马自达	马自达汽车公司
秦皇岛骊骅淀粉股份有限公司	秦皇岛骊骅淀粉股份有限公司
骊骅淀粉	秦皇岛骊骅淀粉股份有限公司
中星微电子有限公司	中星微电子有限公司
中星微电子	中星微电子有限公司
天地源股份有限公司	天地源股份有限公司
天地源	天地源股份有限公司
天津天保基建股份有限公司	天津天保基建股份有限公司
天保基建	天津天保基建股份有限公司
浙江中大集团股份有限公司	浙江中大集团股份有限公司
中大股份	浙江中大集团股份有限公司
厦门国际航空港股份有限公司	厦门国际航空港股份有限公司
厦门空港	厦门国际航空港股份有限公司
中国石化上海石油化工股份有限公司	中国石化上海石油化工股份有限公司
上海石化.*S上石化	中国石化上海石油化工股份有限公司
广东水电二局股份有限公司	广东水电二局股份有限公司
粤水电	广东水电二局股份有限公司
新界泵业集团股份有限公司	新界泵业集团股份有限公司
新界泵业	新界泵业集团股份有限公司
快钱信息服务有限公司	快钱信息服务有限公司
快钱	快钱信息服务有限公司
无锡华光锅炉股份有限公司	无锡华光锅炉股份有限公司
华光股份	无锡华光锅炉股份有限公司
软件银行集团公司	软件银行集团公司
软银	软件银行集团公司
北方导航控制技术股份有限公司	北方导航控制技术股份有限公司
北方导航	北方导航控制技术股份有限公司
北京宝恒典当有限责任公司	北京宝恒典当有限责任公司
宝恒典当	北京宝恒典当有限责任公司
哈慈股份有限公司	哈慈股份有限公司
哈慈股份.*\\*ST哈慈	哈慈股份有限公司
海航集团有限公司	海航集团有限公司
海航	海航集团有限公司
深圳市中侨发展股份有限公司	深圳市中侨发展股份有限公司
深中侨	深圳市中侨发展股份有限公司
新疆百花村股份有限公司	新疆百花村股份有限公司
百花村	新疆百花村股份有限公司
广东省广盐集团有限公司	广东省广盐集团有限公司
广盐集团	广东省广盐集团有限公司
人民网股份有限公司	人民网股份有限公司
人民网	人民网股份有限公司
吉视传媒股份有限公司	吉视传媒股份有限公司
吉视传媒	吉视传媒股份有限公司
zhongguojingjiwang	zhongguojingjiwang
中国经济网	zhongguojingjiwang
贵州信邦制药股份有限公司	贵州信邦制药股份有限公司
信邦制药	贵州信邦制药股份有限公司
哈尔滨空调股份有限公司	哈尔滨空调股份有限公司
哈空调	哈尔滨空调股份有限公司
NokiaCorporation	NokiaCorporation
诺基亚	NokiaCorporation
安徽方兴科技股份有限公司	安徽方兴科技股份有限公司
方兴科技	安徽方兴科技股份有限公司
江苏江中集团	江苏江中集团
江苏江中集团	江苏江中集团
北京华谊嘉信整合营销顾问集团股份有限公司	北京华谊嘉信整合营销顾问集团股份有限公司
华谊嘉信	北京华谊嘉信整合营销顾问集团股份有限公司
北京翠微大厦股份有限公司	北京翠微大厦股份有限公司
翠微股份	北京翠微大厦股份有限公司
微软公司（microsoft）	微软公司（microsoft）
微软	微软公司（microsoft）
广东明家科技股份有限公司	广东明家科技股份有限公司
明家科技	广东明家科技股份有限公司
德国邮政集团	德国邮政集团
德国邮政	德国邮政集团
河南瑞贝卡发制品股份有限公司	河南瑞贝卡发制品股份有限公司
瑞贝卡	河南瑞贝卡发制品股份有限公司
宁夏赛马实业股份有限公司	宁夏赛马实业股份有限公司
赛马实业	宁夏赛马实业股份有限公司
深圳键桥通讯技术股份有限公司	深圳键桥通讯技术股份有限公司
键桥通讯	深圳键桥通讯技术股份有限公司
有研半导体材料股份有限公司	有研半导体材料股份有限公司
有研硅股	有研半导体材料股份有限公司
日本爱信精机公司	日本爱信精机公司
爱信精机	日本爱信精机公司
上海和黄药业有限公司	上海和黄药业有限公司
和黄药业	上海和黄药业有限公司
上海柘中建设股份有限公司	上海柘中建设股份有限公司
柘中建设	上海柘中建设股份有限公司
荷兰国际集团	荷兰国际集团
荷兰国际集团	荷兰国际集团
广达电脑	广达电脑
广达电脑	广达电脑
一汽轿车股份有限公司	一汽轿车股份有限公司
一汽轿车	一汽轿车股份有限公司
深圳市纺织(集团)股份有限公司	深圳市纺织(集团)股份有限公司
深纺织.*深纺织Ａ	深圳市纺织(集团)股份有限公司
厦门金龙汽车集团股份有限公司	厦门金龙汽车集团股份有限公司
金龙汽车	厦门金龙汽车集团股份有限公司
江苏江南高纤股份有限公司	江苏江南高纤股份有限公司
江南高纤	江苏江南高纤股份有限公司
华斯农业开发股份有限公司	华斯农业开发股份有限公司
华斯股份	华斯农业开发股份有限公司
威达医用科技股份有限公司	威达医用科技股份有限公司
\\*ST威达	威达医用科技股份有限公司
重庆九龙电力股份有限公司	重庆九龙电力股份有限公司
九龙电力	重庆九龙电力股份有限公司
中央汇金投资有限责任公司	中央汇金投资有限责任公司
中央汇金	中央汇金投资有限责任公司
湖南太子奶集团	湖南太子奶集团
太子奶	湖南太子奶集团
北京东土科技股份有限公司	北京东土科技股份有限公司
东土科技	北京东土科技股份有限公司
华林证券有限责任公司	华林证券有限责任公司
华林证券	华林证券有限责任公司
德国复兴信贷银行	德国复兴信贷银行
复兴信贷银行	德国复兴信贷银行
湖南凯美特气体股份有限公司	湖南凯美特气体股份有限公司
凯美特气	湖南凯美特气体股份有限公司
深圳市太光电信股份有限公司	深圳市太光电信股份有限公司
太光电信.*\\*ST太光	深圳市太光电信股份有限公司
浙江晶盛机电股份有限公司	浙江晶盛机电股份有限公司
晶盛机电	浙江晶盛机电股份有限公司
京能置业股份有限公司	京能置业股份有限公司
京能置业	京能置业股份有限公司
兴业皮革科技股份有限公司	兴业皮革科技股份有限公司
兴业科技	兴业皮革科技股份有限公司
索菲亚家居股份有限公司	索菲亚家居股份有限公司
索菲亚	索菲亚家居股份有限公司
安徽金种子酒业股份有限公司	安徽金种子酒业股份有限公司
金种子酒	安徽金种子酒业股份有限公司
神州数码控股有限公司	神州数码控股有限公司
神州数码	神州数码控股有限公司
大连电瓷集团股份有限公司	大连电瓷集团股份有限公司
大连电瓷	大连电瓷集团股份有限公司
苏州博瑞生物医药技术有限公司	苏州博瑞生物医药技术有限公司
博瑞生物	苏州博瑞生物医药技术有限公司
德邦基金管理有限公司	德邦基金管理有限公司
德邦基金	德邦基金管理有限公司
青海明胶股份有限公司	青海明胶股份有限公司
青海明胶	青海明胶股份有限公司
中海地产股份有限公司	中海地产股份有限公司
中海地产	中海地产股份有限公司
蜀龙网	蜀龙网
蜀龙网	蜀龙网
浙江景兴纸业股份有限公司	浙江景兴纸业股份有限公司
景兴纸业	浙江景兴纸业股份有限公司
天津泰达股份有限公司	天津泰达股份有限公司
泰达股份	天津泰达股份有限公司
北青网－北京青年报	北青网－北京青年报
北京青年报	北青网－北京青年报
新余钢铁有限责任公司	新余钢铁有限责任公司
新钢公司.*新余钢铁	新余钢铁有限责任公司
湖南友谊阿波罗商业股份有限公司	湖南友谊阿波罗商业股份有限公司
友阿股份	湖南友谊阿波罗商业股份有限公司
中粮集团有限公司	中粮集团有限公司
中粮集团	中粮集团有限公司
新疆青松建材化工集团股份有限公司	新疆青松建材化工集团股份有限公司
青松建化	新疆青松建材化工集团股份有限公司
上海光明食品集团有限公司	上海光明食品集团有限公司
光明食品	上海光明食品集团有限公司
湖北华昌达智能装备股份有限公司	湖北华昌达智能装备股份有限公司
华昌达	湖北华昌达智能装备股份有限公司
山东好当家海洋发展股份有限公司	山东好当家海洋发展股份有限公司
好当家	山东好当家海洋发展股份有限公司
广东宝利来投资股份有限公司	广东宝利来投资股份有限公司
宝利来	广东宝利来投资股份有限公司
新华悦动传媒集团	新华悦动传媒集团
新华悦动传媒	新华悦动传媒集团
海王国际集团有限公司	海王国际集团有限公司
海王集团	海王国际集团有限公司
宋都基业投资股份有限公司	宋都基业投资股份有限公司
宋都股份	宋都基业投资股份有限公司
安联保险集团	安联保险集团
安联	安联保险集团
上海康耐特光学股份有限公司	上海康耐特光学股份有限公司
康耐特	上海康耐特光学股份有限公司
艺龙旅行网	艺龙旅行网
艺龙	艺龙旅行网
七喜控股股份有限公司	七喜控股股份有限公司
七喜控股	七喜控股股份有限公司
创维集团有限公司	创维集团有限公司
创维	创维集团有限公司
深圳浩宁达仪表股份有限公司	深圳浩宁达仪表股份有限公司
浩宁达	深圳浩宁达仪表股份有限公司
江苏联环药业股份有限公司	江苏联环药业股份有限公司
联环药业	江苏联环药业股份有限公司
福建东百集团股份有限公司	福建东百集团股份有限公司
东百集团	福建东百集团股份有限公司
美国CVSCaremark公司	美国CVSCaremark公司
CVSCaremark	美国CVSCaremark公司
齐鲁晚报	齐鲁晚报
齐鲁晚报	齐鲁晚报
山东共达电声股份有限公司	山东共达电声股份有限公司
共达电声	山东共达电声股份有限公司
雅致集成房屋股份有限公司	雅致集成房屋股份有限公司
雅致股份	雅致集成房屋股份有限公司
桂林三金药业股份有限公司	桂林三金药业股份有限公司
桂林三金	桂林三金药业股份有限公司
起亚汽车公司	起亚汽车公司
起亚	起亚汽车公司
北京久其软件股份有限公司	北京久其软件股份有限公司
久其软件	北京久其软件股份有限公司
天津百利特精电气股份有限公司	天津百利特精电气股份有限公司
百利电气	天津百利特精电气股份有限公司
安徽安科生物工程(集团)股份有限公司	安徽安科生物工程(集团)股份有限公司
安科生物	安徽安科生物工程(集团)股份有限公司
中国平安保险集团股份有限公司	中国平安保险集团股份有限公司
中国平安	中国平安保险集团股份有限公司
易居（中国）控股有限公司	易居（中国）控股有限公司
易居（中国）	易居（中国）控股有限公司
安徽鑫科新材料股份有限公司	安徽鑫科新材料股份有限公司
鑫科材料	安徽鑫科新材料股份有限公司
山东益生种畜禽股份有限公司	山东益生种畜禽股份有限公司
益生股份	山东益生种畜禽股份有限公司
盛达矿业股份有限公司	盛达矿业股份有限公司
盛达矿业	盛达矿业股份有限公司
四川银山化工(集团)股份有限公司	四川银山化工(集团)股份有限公司
银山化工	四川银山化工(集团)股份有限公司
山东新华锦国际股份有限公司	山东新华锦国际股份有限公司
新华锦	山东新华锦国际股份有限公司
中国证券市场设计研究中心	中国证券市场设计研究中心
联办	中国证券市场设计研究中心
福田雷沃国际重工股份有限公	福田雷沃国际重工股份有限公
福田雷沃	福田雷沃国际重工股份有限公
信德集团有限公司	信德集团有限公司
信德集团	信德集团有限公司
金陵药业股份有限公司	金陵药业股份有限公司
金陵药业	金陵药业股份有限公司
广东嘉应制药股份有限公司	广东嘉应制药股份有限公司
嘉应制药	广东嘉应制药股份有限公司
罗技有限公司	罗技有限公司
罗技	罗技有限公司
长江证券股份有限公司	长江证券股份有限公司
长江证券	长江证券股份有限公司
江苏常铝铝业股份有限公司	江苏常铝铝业股份有限公司
常铝股份	江苏常铝铝业股份有限公司
宏瑞集团有限公司	宏瑞集团有限公司
宏瑞集团	宏瑞集团有限公司
中国有色矿业集团有限公司	中国有色矿业集团有限公司
中国有色矿业集团有限公司	中国有色矿业集团有限公司
维达纸业集团	维达纸业集团
维达纸业	维达纸业集团
意尔康鞋业集团有限公司	意尔康鞋业集团有限公司
意尔康	意尔康鞋业集团有限公司
文峰大世界连锁发展股份有限公司	文峰大世界连锁发展股份有限公司
文峰股份	文峰大世界连锁发展股份有限公司
上置集团有限公司	上置集团有限公司
上置集团	上置集团有限公司
中兵光电科技股份有限公司	中兵光电科技股份有限公司
中兵光电	中兵光电科技股份有限公司
周大福集团	周大福集团
周大福	周大福集团
贵州长征天成控股股份有限公司	贵州长征天成控股股份有限公司
天成控股	贵州长征天成控股股份有限公司
联美控股股份有限公司	联美控股股份有限公司
联美控股	联美控股股份有限公司
扬子江药业集团	扬子江药业集团
扬子江药业	扬子江药业集团
上海复旦复华科技股份有限公司	上海复旦复华科技股份有限公司
复旦复华	上海复旦复华科技股份有限公司
嘉事堂药业股份有限公司	嘉事堂药业股份有限公司
嘉事堂	嘉事堂药业股份有限公司
广东万和新电气股份有限公司	广东万和新电气股份有限公司
万和电气	广东万和新电气股份有限公司
香港交易及结算所有限公司	香港交易及结算所有限公司
港交所	香港交易及结算所有限公司
长春一汽富维汽车零部件股份有限公司	长春一汽富维汽车零部件股份有限公司
一汽富维	长春一汽富维汽车零部件股份有限公司
深圳市普联技术有限公司	深圳市普联技术有限公司
深圳普联	深圳市普联技术有限公司
中兴通讯股份有限公司	中兴通讯股份有限公司
中兴通讯	中兴通讯股份有限公司
信雅达系统工程股份有限公司	信雅达系统工程股份有限公司
信雅达	信雅达系统工程股份有限公司
ソニー株式会社，SonyCorporation	ソニー株式会社，SonyCorporation
索尼	ソニー株式会社，SonyCorporation
广州市广百股份有限公司	广州市广百股份有限公司
广百股份	广州市广百股份有限公司
友邦华泰基金管理有限公司	友邦华泰基金管理有限公司
友邦华泰	友邦华泰基金管理有限公司
四川双马水泥股份有限公司	四川双马水泥股份有限公司
四川双马	四川双马水泥股份有限公司
宁波立立电子股份有限公司	宁波立立电子股份有限公司
立立电子	宁波立立电子股份有限公司
铜陵精达特种电磁线股份有限公司	铜陵精达特种电磁线股份有限公司
精达股份	铜陵精达特种电磁线股份有限公司
保定天鹅股份有限公司	保定天鹅股份有限公司
保定天鹅	保定天鹅股份有限公司
江西三川水表股份有限公司	江西三川水表股份有限公司
三川股份	江西三川水表股份有限公司
现代汽车公司	现代汽车公司
现代汽车	现代汽车公司
西安启源机电装备股份有限公司	西安启源机电装备股份有限公司
启源装备	西安启源机电装备股份有限公司
方正科技集团股份有限公司	方正科技集团股份有限公司
方正科技	方正科技集团股份有限公司
大连机床集团公司	大连机床集团公司
大连机床	大连机床集团公司
上海机电股份有限公司	上海机电股份有限公司
上海机电	上海机电股份有限公司
无锡和晶科技股份有限公司	无锡和晶科技股份有限公司
和晶科技	无锡和晶科技股份有限公司
深圳市鸿基集团股份有限公司	深圳市鸿基集团股份有限公司
深鸿基	深圳市鸿基集团股份有限公司
山东金城医药化工股份有限公司	山东金城医药化工股份有限公司
金城医药	山东金城医药化工股份有限公司
北京王致和食品集团有限公司	北京王致和食品集团有限公司
王致和	北京王致和食品集团有限公司
深圳中航地产股份有限公司	深圳中航地产股份有限公司
中航地产	深圳中航地产股份有限公司
大连港股份有限公司	大连港股份有限公司
大连港	大连港股份有限公司
安信基金管理有限责任公司	安信基金管理有限责任公司
安信基金	安信基金管理有限责任公司
澳大利亚伍尔沃斯公司	澳大利亚伍尔沃斯公司
伍尔沃斯	澳大利亚伍尔沃斯公司
江苏德威新材料股份有限公司	江苏德威新材料股份有限公司
德威新材	江苏德威新材料股份有限公司
兰州铝业股份有限公司	兰州铝业股份有限公司
兰州铝业.*S兰铝	兰州铝业股份有限公司
黑龙江北大荒农业股份有限公司	黑龙江北大荒农业股份有限公司
北大荒	黑龙江北大荒农业股份有限公司
保定天威保变电气股份有限公司	保定天威保变电气股份有限公司
天威保变	保定天威保变电气股份有限公司
深圳世联地产顾问股份有限公司　	深圳世联地产顾问股份有限公司　
世联地产	深圳世联地产顾问股份有限公司　
申洲国际集团控股有限公司	申洲国际集团控股有限公司
申洲集团.*申洲国际	申洲国际集团控股有限公司
洽洽食品股份有限公司	洽洽食品股份有限公司
洽洽食品	洽洽食品股份有限公司
北青网	北青网
北青网	北青网
上海安诺其纺织化工股份有限公司	上海安诺其纺织化工股份有限公司
安诺其	上海安诺其纺织化工股份有限公司
多氟多化工股份有限公司	多氟多化工股份有限公司
多氟多	多氟多化工股份有限公司
沃尔玛百货有限公司	沃尔玛百货有限公司
沃尔玛	沃尔玛百货有限公司
青海盐湖工业股份有限公司	青海盐湖工业股份有限公司
盐湖股份	青海盐湖工业股份有限公司
深圳宝德网络技术有限公司	深圳宝德网络技术有限公司
深圳宝德网络	深圳宝德网络技术有限公司
四川国栋建设股份有限公司	四川国栋建设股份有限公司
国栋建设	四川国栋建设股份有限公司
辽宁海诺建设机械集团有限公司	辽宁海诺建设机械集团有限公司
海诺集团	辽宁海诺建设机械集团有限公司
浙江航民股份有限公司	浙江航民股份有限公司
航民股份	浙江航民股份有限公司
GianniVersaceSpA集团	GianniVersaceSpA集团
范思哲	GianniVersaceSpA集团
怀集登云汽配股份有限公司	怀集登云汽配股份有限公司
登云股份	怀集登云汽配股份有限公司
通化双龙化工股份有限公司	通化双龙化工股份有限公司
双龙股份	通化双龙化工股份有限公司
云南盐化股份有限公司	云南盐化股份有限公司
云南盐化	云南盐化股份有限公司
龙元建设集团股份有限公司	龙元建设集团股份有限公司
龙元建设	龙元建设集团股份有限公司
浙江银轮机械股份有限公司	浙江银轮机械股份有限公司
银轮股份	浙江银轮机械股份有限公司
黑龙江黑化股份有限公司	黑龙江黑化股份有限公司
黑化股份	黑龙江黑化股份有限公司
今日资本	今日资本
今日资本	今日资本
广东新宝电器股份有限公司	广东新宝电器股份有限公司
新宝股份	广东新宝电器股份有限公司
上海现代制药股份有限公司	上海现代制药股份有限公司
现代制药	上海现代制药股份有限公司
广东锦龙发展股份有限公司	广东锦龙发展股份有限公司
锦龙股份	广东锦龙发展股份有限公司
酒泉钢铁（集团）有限责任公司	酒泉钢铁（集团）有限责任公司
酒泉钢铁	酒泉钢铁（集团）有限责任公司
经理人传媒有限公司	经理人传媒有限公司
经理人	经理人传媒有限公司
福建双飞日化有限公司	福建双飞日化有限公司
双飞日化	福建双飞日化有限公司
内蒙古北方重型汽车股份有限公司	内蒙古北方重型汽车股份有限公司
北方股份	内蒙古北方重型汽车股份有限公司
中原大地传媒股份有限公司	中原大地传媒股份有限公司
大地传媒	中原大地传媒股份有限公司
纽约期货交易所	纽约期货交易所
纽约期货交易所	纽约期货交易所
华意压缩机股份有限公司	华意压缩机股份有限公司
华意压缩	华意压缩机股份有限公司
上海永生数据科技股份有限公司	上海永生数据科技股份有限公司
永生数据	上海永生数据科技股份有限公司
上海海立(集团)股份有限公司	上海海立(集团)股份有限公司
海立股份	上海海立(集团)股份有限公司
浙江钱江摩托股份有限公司	浙江钱江摩托股份有限公司
钱江摩托	浙江钱江摩托股份有限公司
北京飞利信科技股份有限公司	北京飞利信科技股份有限公司
飞利信	北京飞利信科技股份有限公司
武汉三特索道集团股份有限公司	武汉三特索道集团股份有限公司
三特索道	武汉三特索道集团股份有限公司
广东全通教育股份有限公司	广东全通教育股份有限公司
全通教育	广东全通教育股份有限公司
华商基金管理公司	华商基金管理公司
华商基金	华商基金管理公司
威海市金猴集团有限责任公司	威海市金猴集团有限责任公司
金猴集团	威海市金猴集团有限责任公司
云南南天电子信息产业股份有限公司	云南南天电子信息产业股份有限公司
南天信息	云南南天电子信息产业股份有限公司
安徽恒源煤电股份有限公司	安徽恒源煤电股份有限公司
恒源煤电	安徽恒源煤电股份有限公司
福建三木集团股份有限公司	福建三木集团股份有限公司
三木集团	福建三木集团股份有限公司
内蒙古西水创业股份有限公司	内蒙古西水创业股份有限公司
西水股份	内蒙古西水创业股份有限公司
英皇娱乐集团有限公司	英皇娱乐集团有限公司
英皇国际	英皇娱乐集团有限公司
苏州海陆重工股份有限公司	苏州海陆重工股份有限公司
海陆重工	苏州海陆重工股份有限公司
青海新闻网	青海新闻网
青海新闻网	青海新闻网
飞亚达（集团）股份有限公司	飞亚达（集团）股份有限公司
飞亚达Ａ	飞亚达（集团）股份有限公司
GoldmanSachsGroupInc.	GoldmanSachsGroupInc.
高盛	GoldmanSachsGroupInc.
英美资源集团股份有限公司	英美资源集团股份有限公司
英美资源集团	英美资源集团股份有限公司
广东潮宏基实业股份有限公司	广东潮宏基实业股份有限公司
潮宏基	广东潮宏基实业股份有限公司
北京大正语言知识处理科技有限公司	北京大正语言知识处理科技有限公司
北京大正	北京大正语言知识处理科技有限公司
上海证券报	上海证券报
上海证券报	上海证券报
涟源钢铁集团有限公司	涟源钢铁集团有限公司
涟源钢铁	涟源钢铁集团有限公司
北京京城机电控股有限责任公司	北京京城机电控股有限责任公司
京城控股	北京京城机电控股有限责任公司
KohlbergKravisRoberts	KohlbergKravisRoberts
KKR集团	KohlbergKravisRoberts
凤凰光学股份有限公司	凤凰光学股份有限公司
凤凰光学	凤凰光学股份有限公司
乐普（北京）医疗器械股份有限公司	乐普（北京）医疗器械股份有限公司
乐普医疗	乐普（北京）医疗器械股份有限公司
华北高速公路股份有限公司	华北高速公路股份有限公司
华北高速	华北高速公路股份有限公司
广东珠江典当行	广东珠江典当行
珠江典当	广东珠江典当行
西安达尔曼实业股份有限公司	西安达尔曼实业股份有限公司
达尔曼	西安达尔曼实业股份有限公司
电讯盈科有限公司	电讯盈科有限公司
电讯盈科	电讯盈科有限公司
大众网	大众网
大众网	大众网
红河烟草（集团）有限责任公司	红河烟草（集团）有限责任公司
红河烟草	红河烟草（集团）有限责任公司
深圳市芭田生态工程股份有限公司	深圳市芭田生态工程股份有限公司
芭田股份	深圳市芭田生态工程股份有限公司
广东德豪润达电气股份有限公司	广东德豪润达电气股份有限公司
德豪润达	广东德豪润达电气股份有限公司
读卖新闻	读卖新闻
读卖新闻	读卖新闻
天壕节能科技股份有限公司	天壕节能科技股份有限公司
天壕节能	天壕节能科技股份有限公司
中油吉林化建工程股份有限公司	中油吉林化建工程股份有限公司
山煤国际	中油吉林化建工程股份有限公司
上海超日太阳能科技股份有限公司	上海超日太阳能科技股份有限公司
超日太阳.*\\*ST超日	上海超日太阳能科技股份有限公司
南方黑芝麻集团股份有限公司	南方黑芝麻集团股份有限公司
南方食品	南方黑芝麻集团股份有限公司
汇添富基金管理股份有限公司	汇添富基金管理股份有限公司
汇添富	汇添富基金管理股份有限公司
惠氏制药有限公司	惠氏制药有限公司
惠氏	惠氏制药有限公司
宁波双林汽车部件股份有限公司	宁波双林汽车部件股份有限公司
双林股份	宁波双林汽车部件股份有限公司
中国太平洋保险(集团)股份有限公司	中国太平洋保险(集团)股份有限公司
中国太保	中国太平洋保险(集团)股份有限公司
浙江钱江生物化学股份有限公司	浙江钱江生物化学股份有限公司
钱江生化	浙江钱江生物化学股份有限公司
网宿科技股份有限公司	网宿科技股份有限公司
网宿科技	网宿科技股份有限公司
大连壹桥海洋苗业股份有限公司	大连壹桥海洋苗业股份有限公司
壹桥苗业	大连壹桥海洋苗业股份有限公司
浙大网新科技股份有限公司	浙大网新科技股份有限公司
浙大网新	浙大网新科技股份有限公司
广联达软件股份有限公司	广联达软件股份有限公司
广联达	广联达软件股份有限公司
东方日升新能源股份有限公司	东方日升新能源股份有限公司
东方日升	东方日升新能源股份有限公司
成都高新发展股份有限公司	成都高新发展股份有限公司
高新发展	成都高新发展股份有限公司
深圳赛格股份有限公司	深圳赛格股份有限公司
深赛格.*ST赛格	深圳赛格股份有限公司
易联众信息技术股份有限公司	易联众信息技术股份有限公司
易联众	易联众信息技术股份有限公司
浙江赞宇科技股份有限公司	浙江赞宇科技股份有限公司
赞宇科技	浙江赞宇科技股份有限公司
上海创兴资源开发股份有限公司	上海创兴资源开发股份有限公司
创兴资源	上海创兴资源开发股份有限公司
财富证券	财富证券
财富证券	财富证券
九牧王福建服饰发展有限公司	九牧王福建服饰发展有限公司
九牧王	九牧王福建服饰发展有限公司
标准渣打银行	标准渣打银行
渣打银行	标准渣打银行
桂林旅游股份有限公司	桂林旅游股份有限公司
桂林旅游	桂林旅游股份有限公司
洛阳北方玻璃技术股份有限公司	洛阳北方玻璃技术股份有限公司
北玻股份	洛阳北方玻璃技术股份有限公司
深圳市腾讯计算机系统有限公司	深圳市腾讯计算机系统有限公司
腾讯	深圳市腾讯计算机系统有限公司
合肥钢铁集团钢管有限责任公司	合肥钢铁集团钢管有限责任公司
合肥钢铁	合肥钢铁集团钢管有限责任公司
上海广电电气(集团)股份有限公司	上海广电电气(集团)股份有限公司
广电电气	上海广电电气(集团)股份有限公司
成都三泰电子实业股份有限公司	成都三泰电子实业股份有限公司
三泰电子	成都三泰电子实业股份有限公司
优酷网	优酷网
优酷网	优酷网
内蒙古和信园蒙草抗旱绿化股份有限公司	内蒙古和信园蒙草抗旱绿化股份有限公司
蒙草抗旱	内蒙古和信园蒙草抗旱绿化股份有限公司
克明面业股份有限公司	克明面业股份有限公司
克明面业	克明面业股份有限公司
南京证券有限责任公司	南京证券有限责任公司
南京证券	南京证券有限责任公司
汕头电力发展股份有限公司	汕头电力发展股份有限公司
汕电力A	汕头电力发展股份有限公司
中船钢构工程股份有限公司	中船钢构工程股份有限公司
钢构工程	中船钢构工程股份有限公司
深圳市昌红科技股份有限公司	深圳市昌红科技股份有限公司
昌红科技	深圳市昌红科技股份有限公司
凯撒(中国)股份有限公司	凯撒(中国)股份有限公司
凯撒股份	凯撒(中国)股份有限公司
云南云维股份有限公司	云南云维股份有限公司
云维股份	云南云维股份有限公司
上海百润香精香料股份有限公司	上海百润香精香料股份有限公司
百润股份	上海百润香精香料股份有限公司
新日本石油公司	新日本石油公司
新日本石油	新日本石油公司
中国纺织报	中国纺织报
中国纺织报	中国纺织报
上海汽车工业（集团）总公司	上海汽车工业（集团）总公司
上汽集团	上海汽车工业（集团）总公司
云南西仪工业股份有限公司	云南西仪工业股份有限公司
西仪股份.*\\*ST西仪	云南西仪工业股份有限公司
中国华能集团	中国华能集团
中国华能	中国华能集团
中海基金管理有限公司	中海基金管理有限公司
中海基金	中海基金管理有限公司
佳都新太科技股份有限公司	佳都新太科技股份有限公司
佳都科技	佳都新太科技股份有限公司
上海新梅置业股份有限公司	上海新梅置业股份有限公司
上海新梅	上海新梅置业股份有限公司
四川明星电力股份有限公司	四川明星电力股份有限公司
明星电力	四川明星电力股份有限公司
兰州三毛实业股份有限公司	兰州三毛实业股份有限公司
三毛派神.*ST派神	兰州三毛实业股份有限公司
重庆渝安创新科技集团有限公司	重庆渝安创新科技集团有限公司
渝安集团	重庆渝安创新科技集团有限公司
福建三农集团股份有限公司	福建三农集团股份有限公司
S\\*ST三农	福建三农集团股份有限公司
安徽合力股份有限公司	安徽合力股份有限公司
安徽合力	安徽合力股份有限公司
法人	法人
法人	法人
黑龙江交通发展股份有限公司	黑龙江交通发展股份有限公司
龙江交通	黑龙江交通发展股份有限公司
重庆秋田齿轮有限责任公司	重庆秋田齿轮有限责任公司
秋田齿轮	重庆秋田齿轮有限责任公司
浙江富春江环保热电股份有限公司	浙江富春江环保热电股份有限公司
富春环保	浙江富春江环保热电股份有限公司
上海振华重工(集团)股份有限公司	上海振华重工(集团)股份有限公司
振华重工	上海振华重工(集团)股份有限公司
聚光科技(杭州)股份有限公司	聚光科技(杭州)股份有限公司
聚光科技	聚光科技(杭州)股份有限公司
辽河金马油田股份有限公司	辽河金马油田股份有限公司
辽河油田	辽河金马油田股份有限公司
上海东方明珠集团股份有限公司	上海东方明珠集团股份有限公司
东方明珠	上海东方明珠集团股份有限公司
内蒙古远兴能源股份有限公司	内蒙古远兴能源股份有限公司
远兴能源.*内蒙古远兴	内蒙古远兴能源股份有限公司
天津环球磁卡股份有限公司	天津环球磁卡股份有限公司
天津磁卡.*ST磁卡	天津环球磁卡股份有限公司
东方网	东方网
东方网	东方网
长春高斯达生物科技集团股份有限公司	长春高斯达生物科技集团股份有限公司
高斯达	长春高斯达生物科技集团股份有限公司
广东易事特电源股份有限公司	广东易事特电源股份有限公司
易事特	广东易事特电源股份有限公司
深圳市佳创视讯技术股份有限公司	深圳市佳创视讯技术股份有限公司
佳创视讯	深圳市佳创视讯技术股份有限公司
文思信息技术公司	文思信息技术公司
文思信息	文思信息技术公司
顾地科技股份有限公司	顾地科技股份有限公司
顾地科技	顾地科技股份有限公司
重庆金科实业（集团）有限公司	重庆金科实业（集团）有限公司
金科集团	重庆金科实业（集团）有限公司
四川攀枝花钢铁集团有限公司	四川攀枝花钢铁集团有限公司
攀枝花钢铁	四川攀枝花钢铁集团有限公司
北方光电股份有限公司	北方光电股份有限公司
光电股份	北方光电股份有限公司
山西三维集团股份有限公司	山西三维集团股份有限公司
山西三维	山西三维集团股份有限公司
用友软件股份有限公司	用友软件股份有限公司
用友软件	用友软件股份有限公司
广佛都市网	广佛都市网
广佛都市网	广佛都市网
黑龙江省完达山乳业股份有限公司	黑龙江省完达山乳业股份有限公司
完达山乳业	黑龙江省完达山乳业股份有限公司
中国中铁股份有限公司	中国中铁股份有限公司
中国中铁	中国中铁股份有限公司
华力创通科技有限公司	华力创通科技有限公司
华力创通	华力创通科技有限公司
浙江伟星实业发展股份有限公司	浙江伟星实业发展股份有限公司
伟星股份	浙江伟星实业发展股份有限公司
福建金森林业股份有限公司	福建金森林业股份有限公司
福建金森	福建金森林业股份有限公司
俄罗斯天然气工业公司	俄罗斯天然气工业公司
俄罗斯天然气公司	俄罗斯天然气工业公司
浙江永贵电器股份有限公司	浙江永贵电器股份有限公司
永贵电器	浙江永贵电器股份有限公司
安徽华茂纺织股份有限公司	安徽华茂纺织股份有限公司
华茂股份	安徽华茂纺织股份有限公司
海亮集团有限公司	海亮集团有限公司
海亮集团	海亮集团有限公司
河北建投能源投资股份有限公司	河北建投能源投资股份有限公司
建投能源	河北建投能源投资股份有限公司
华菱星马汽车(集团)股份有限公司	华菱星马汽车(集团)股份有限公司
华菱星马	华菱星马汽车(集团)股份有限公司
LuckyGoldstar	LuckyGoldstar
LG	LuckyGoldstar
中国国际航空股份有限公司	中国国际航空股份有限公司
中国国航	中国国际航空股份有限公司
平顶山天安煤业股份有限公司	平顶山天安煤业股份有限公司
平煤股份	平顶山天安煤业股份有限公司
湖南博云新材料股份有限公司	湖南博云新材料股份有限公司
博云新材	湖南博云新材料股份有限公司
双良节能系统股份有限公司	双良节能系统股份有限公司
双良节能	双良节能系统股份有限公司
中国太平保险集团公司	中国太平保险集团公司
中国太平保险	中国太平保险集团公司
天正集团有限公司	天正集团有限公司
天正集团	天正集团有限公司
山东豪迈机械科技股份有限公司	山东豪迈机械科技股份有限公司
豪迈科技	山东豪迈机械科技股份有限公司
中国中信集团公司	中国中信集团公司
中信集团	中国中信集团公司
金轮科创股份有限公司	金轮科创股份有限公司
金轮股份	金轮科创股份有限公司
中国普天信息产业集团公司	中国普天信息产业集团公司
中国普天	中国普天信息产业集团公司
连云港如意集团股份有限公司	连云港如意集团股份有限公司
如意集团	连云港如意集团股份有限公司
苏州苏大维格光电科技股份有限公司	苏州苏大维格光电科技股份有限公司
苏大维格	苏州苏大维格光电科技股份有限公司
五矿发展股份有限公司	五矿发展股份有限公司
五矿发展	五矿发展股份有限公司
深圳市天威视讯股份有限公司	深圳市天威视讯股份有限公司
天威视讯	深圳市天威视讯股份有限公司
新湖中宝股份有限公司	新湖中宝股份有限公司
新湖中宝	新湖中宝股份有限公司
西安宝德自动化股份有限公司	西安宝德自动化股份有限公司
宝德股份.*西安宝德	西安宝德自动化股份有限公司
哈尔滨电气集团公司	哈尔滨电气集团公司
哈电集团	哈尔滨电气集团公司
江苏华丰不锈钢制品有限公司	江苏华丰不锈钢制品有限公司
华丰集团	江苏华丰不锈钢制品有限公司
广东世荣兆业股份有限公司	广东世荣兆业股份有限公司
世荣兆业	广东世荣兆业股份有限公司
广东省广告股份有限公司	广东省广告股份有限公司
省广股份	广东省广告股份有限公司
三江购物俱乐部股份有限公司	三江购物俱乐部股份有限公司
三江购物	三江购物俱乐部股份有限公司
重庆市迪马实业股份有限公司	重庆市迪马实业股份有限公司
迪马股份	重庆市迪马实业股份有限公司
郑州商品交易所	郑州商品交易所
郑商所	郑州商品交易所
上海中科合臣股份有限公司	上海中科合臣股份有限公司
中科合臣	上海中科合臣股份有限公司
广州东华实业股份有限公司	广州东华实业股份有限公司
东华实业	广州东华实业股份有限公司
广州毅昌科技股份有限公司	广州毅昌科技股份有限公司
毅昌股份	广州毅昌科技股份有限公司
江苏蓝丰生物化工股份有限公司	江苏蓝丰生物化工股份有限公司
蓝丰生化	江苏蓝丰生物化工股份有限公司
安徽皖通科技股份有限公司	安徽皖通科技股份有限公司
皖通科技	安徽皖通科技股份有限公司
建信基金管理公司	建信基金管理公司
建信基金	建信基金管理公司
北京市金保典当行有限责任公司	北京市金保典当行有限责任公司
金保典当	北京市金保典当行有限责任公司
山东南山铝业股份有限公司	山东南山铝业股份有限公司
南山铝业	山东南山铝业股份有限公司
南宁化工股份有限公司	南宁化工股份有限公司
南化股份	南宁化工股份有限公司
哈尔滨秋林集团股份有限公司	哈尔滨秋林集团股份有限公司
秋林集团	哈尔滨秋林集团股份有限公司
张家界新闻网	张家界新闻网
张家界新闻网	张家界新闻网
武汉力诺太阳能集团股份有限公司	武汉力诺太阳能集团股份有限公司
力诺太阳	武汉力诺太阳能集团股份有限公司
贵州钢绳股份有限公司	贵州钢绳股份有限公司
贵绳股份	贵州钢绳股份有限公司
南京红宝丽股份有限公司	南京红宝丽股份有限公司
红宝丽	南京红宝丽股份有限公司
深圳瑞和建筑装饰股份有限公司	深圳瑞和建筑装饰股份有限公司
瑞和股份	深圳瑞和建筑装饰股份有限公司
甘肃宏良皮业股份有限公司	甘肃宏良皮业股份有限公司
宏良股份	甘肃宏良皮业股份有限公司
河北钢铁股份有限公司	河北钢铁股份有限公司
河北钢铁	河北钢铁股份有限公司
天福茗茶	天福茗茶
天福茗茶	天福茗茶
北京华录百纳影视股份有限公司	北京华录百纳影视股份有限公司
华录百纳	北京华录百纳影视股份有限公司
福建福日电子股份有限公司	福建福日电子股份有限公司
福日电子	福建福日电子股份有限公司
浙江东日股份有限公司	浙江东日股份有限公司
浙江东日	浙江东日股份有限公司
新疆独山子天利高新技术股份有限公司	新疆独山子天利高新技术股份有限公司
天利高新	新疆独山子天利高新技术股份有限公司
佛山华新包装股份有限公司	佛山华新包装股份有限公司
华新包装.*粤华包Ｂ	佛山华新包装股份有限公司
长发集团长江投资实业股份有限公司	长发集团长江投资实业股份有限公司
长江投资	长发集团长江投资实业股份有限公司
上海加冷松芝汽车空调股份有限公司	上海加冷松芝汽车空调股份有限公司
松芝股份	上海加冷松芝汽车空调股份有限公司
爱和谊财产保险中国有限公司	爱和谊财产保险中国有限公司
爱和谊保险	爱和谊财产保险中国有限公司
成都金亚科技股份有限公司	成都金亚科技股份有限公司
金亚科技	成都金亚科技股份有限公司
江苏沙钢集团	江苏沙钢集团
江苏沙钢集团	江苏沙钢集团
浙江金固股份有限公司	浙江金固股份有限公司
金固股份	浙江金固股份有限公司
深圳市联建光电股份有限公司	深圳市联建光电股份有限公司
联建光电	深圳市联建光电股份有限公司
支付宝网络技术有限公司	支付宝网络技术有限公司
支付宝	支付宝网络技术有限公司
双龙汽车公司	双龙汽车公司
双龙	双龙汽车公司
台湾大哥大股份有限公司	台湾大哥大股份有限公司
台湾大哥大	台湾大哥大股份有限公司
中润资源投资股份有限公司	中润资源投资股份有限公司
中润资源	中润资源投资股份有限公司
广东盛路通信科技股份有限公司	广东盛路通信科技股份有限公司
盛路通信	广东盛路通信科技股份有限公司
上海益民商业股份有限公司	上海益民商业股份有限公司
益民商业	上海益民商业股份有限公司
上海友谊集团股份有限公司	上海友谊集团股份有限公司
友谊股份	上海友谊集团股份有限公司
国泰金融控股股份有限公司	国泰金融控股股份有限公司
国泰金融控股	国泰金融控股股份有限公司
日本明治安田生命保险公司	日本明治安田生命保险公司
明治安田生命	日本明治安田生命保险公司
广东众生药业股份有限公司	广东众生药业股份有限公司
众生药业	广东众生药业股份有限公司
新疆浩源天然气股份有限公司	新疆浩源天然气股份有限公司
新疆浩源	新疆浩源天然气股份有限公司
郑州煤电股份有限公司	郑州煤电股份有限公司
郑州煤电	郑州煤电股份有限公司
北京国华电力有限责任公司	北京国华电力有限责任公司
国华电力	北京国华电力有限责任公司
天津荣程联合钢铁集团有限公司	天津荣程联合钢铁集团有限公司
天津荣钢	天津荣程联合钢铁集团有限公司
上海金桥出口加工区开发股份有限公司	上海金桥出口加工区开发股份有限公司
浦东金桥	上海金桥出口加工区开发股份有限公司
阿里巴巴网络有限公司	阿里巴巴网络有限公司
阿里巴巴	阿里巴巴网络有限公司
江苏宏宝五金股份有限公司	江苏宏宝五金股份有限公司
江苏宏宝	江苏宏宝五金股份有限公司
四川浪莎控股股份有限公司	四川浪莎控股股份有限公司
浪莎股份	四川浪莎控股股份有限公司
深圳英飞拓科技股份有限公司	深圳英飞拓科技股份有限公司
英飞拓	深圳英飞拓科技股份有限公司
中国机械工业集团公司	中国机械工业集团公司
中国机械工业集团公司	中国机械工业集团公司
四环药业股份有限公司	四环药业股份有限公司
四环药业.*ST四环	四环药业股份有限公司
江中药业股份有限公司	江中药业股份有限公司
江中药业	江中药业股份有限公司
安徽省皖能股份有限公司	安徽省皖能股份有限公司
皖能电力	安徽省皖能股份有限公司
华东医药股份有限公司	华东医药股份有限公司
华东医药	华东医药股份有限公司
湖南投资集团股份有限公司	湖南投资集团股份有限公司
湖南投资	湖南投资集团股份有限公司
上海复星高科技（集团）有限公司	上海复星高科技（集团）有限公司
复星集团	上海复星高科技（集团）有限公司
长春欧亚集团股份有限公司	长春欧亚集团股份有限公司
欧亚集团	长春欧亚集团股份有限公司
广州富力地产股份有限公司	广州富力地产股份有限公司
富力地产	广州富力地产股份有限公司
中天城投集团股份有限公司	中天城投集团股份有限公司
中天城投	中天城投集团股份有限公司
河南中孚实业股份有限公司	河南中孚实业股份有限公司
中孚实业	河南中孚实业股份有限公司
巴黎欧莱雅	巴黎欧莱雅
巴黎欧莱雅	巴黎欧莱雅
潍柴重机股份有限公司	潍柴重机股份有限公司
潍柴重机	潍柴重机股份有限公司
紫金财产保险股份有限公司	紫金财产保险股份有限公司
紫金保险	紫金财产保险股份有限公司
中芯国际集成电路制造有限公司	中芯国际集成电路制造有限公司
中芯国际	中芯国际集成电路制造有限公司
意大利国家电力公司	意大利国家电力公司
意大利电力	意大利国家电力公司
海南航空股份有限公司	海南航空股份有限公司
海南航空	海南航空股份有限公司
浙江华海药业股份有限公司	浙江华海药业股份有限公司
华海药业	浙江华海药业股份有限公司
中国出口信用保险公司	中国出口信用保险公司
中国信保	中国出口信用保险公司
星展银行有限公司	星展银行有限公司
星展银行	星展银行有限公司
深圳中国农大科技股份有限公司	深圳中国农大科技股份有限公司
国农科技	深圳中国农大科技股份有限公司
常熟市天银机电股份有限公司	常熟市天银机电股份有限公司
天银机电	常熟市天银机电股份有限公司
广晟有色金属股份有限公司	广晟有色金属股份有限公司
广晟有色.*ST有色	广晟有色金属股份有限公司
郑州煤矿机械集团股份有限公司	郑州煤矿机械集团股份有限公司
郑煤机	郑州煤矿机械集团股份有限公司
园城实业集团有限公司	园城实业集团有限公司
园城实业	园城实业集团有限公司
廊坊发展股份有限公司	廊坊发展股份有限公司
廊坊发展	廊坊发展股份有限公司
上海第一医药股份有限公司	上海第一医药股份有限公司
第一医药	上海第一医药股份有限公司
内蒙古伊利实业集团股份有限公司	内蒙古伊利实业集团股份有限公司
伊利股份	内蒙古伊利实业集团股份有限公司
江苏长青农化股份有限公司	江苏长青农化股份有限公司
长青股份	江苏长青农化股份有限公司
海南海德实业股份有限公司	海南海德实业股份有限公司
海德股份	海南海德实业股份有限公司
武汉国药科技股份有限公司	武汉国药科技股份有限公司
国药科技	武汉国药科技股份有限公司
南京新联电子股份有限公司	南京新联电子股份有限公司
新联电子	南京新联电子股份有限公司
分众传媒	分众传媒
分众传媒	分众传媒
深圳香江控股股份有限公司	深圳香江控股股份有限公司
香江控股	深圳香江控股股份有限公司
广州市浪奇实业股份有限公司	广州市浪奇实业股份有限公司
广州浪奇	广州市浪奇实业股份有限公司
江苏中超电缆股份有限公司	江苏中超电缆股份有限公司
中超电缆	江苏中超电缆股份有限公司
云南旅游股份有限公司	云南旅游股份有限公司
云南旅游	云南旅游股份有限公司
浙江富润股份有限公司	浙江富润股份有限公司
浙江富润	浙江富润股份有限公司
财通证券有限责任公司	财通证券有限责任公司
财通证券	财通证券有限责任公司
湖南华菱钢铁股份有限公司	湖南华菱钢铁股份有限公司
华菱钢铁	湖南华菱钢铁股份有限公司
中国人民银行网	中国人民银行网
中国人民银行网	中国人民银行网
北京三聚环保新材料股份有限公司	北京三聚环保新材料股份有限公司
三聚环保	北京三聚环保新材料股份有限公司
晋西车轴股份有限公司	晋西车轴股份有限公司
晋西车轴	晋西车轴股份有限公司
大连友谊集团股份有限公司	大连友谊集团股份有限公司
大连友谊	大连友谊集团股份有限公司
老凤祥股份有限公司	老凤祥股份有限公司
老凤祥	老凤祥股份有限公司
山东海化股份有限公司	山东海化股份有限公司
山东海化.*\\*ST海化	山东海化股份有限公司
青岛即发集团控股有限公司	青岛即发集团控股有限公司
青岛即发集团	青岛即发集团控股有限公司
江苏润邦重工股份有限公司	江苏润邦重工股份有限公司
润邦股份	江苏润邦重工股份有限公司
安徽应流机电股份有限公司	安徽应流机电股份有限公司
应流股份	安徽应流机电股份有限公司
浙江传化股份有限公司	浙江传化股份有限公司
传化股份	浙江传化股份有限公司
包商银行	包商银行
包商银行	包商银行
上海美特斯邦威服饰股份有限公司	上海美特斯邦威服饰股份有限公司
美邦服饰	上海美特斯邦威服饰股份有限公司
EstéеLauder	EstéеLauder
EstéеLauder	EstéеLauder
重庆港九股份有限公司	重庆港九股份有限公司
重庆港九	重庆港九股份有限公司
美国迪尔公司	美国迪尔公司
迪尔	美国迪尔公司
广东太阳神集团有限公司	广东太阳神集团有限公司
太阳神	广东太阳神集团有限公司
汇丰控股有限公司	汇丰控股有限公司
汇丰控股	汇丰控股有限公司
苏州电器科学研究院股份有限公司	苏州电器科学研究院股份有限公司
电科院	苏州电器科学研究院股份有限公司
华宝兴业基金管理有限公司	华宝兴业基金管理有限公司
华宝兴业.*华宝兴业基金	华宝兴业基金管理有限公司
西王食品股份有限公司	西王食品股份有限公司
西王食品	西王食品股份有限公司
广东蓉胜超微线材股份有限公司	广东蓉胜超微线材股份有限公司
蓉胜超微	广东蓉胜超微线材股份有限公司
长春高新技术产业集团股份有限公司	长春高新技术产业集团股份有限公司
长春高新	长春高新技术产业集团股份有限公司
宝安鸿基地产集团股份有限公司	宝安鸿基地产集团股份有限公司
宝安地产	宝安鸿基地产集团股份有限公司
北京太空板业股份有限公司	北京太空板业股份有限公司
太空板业	北京太空板业股份有限公司
芜湖港储运股份有限公司	芜湖港储运股份有限公司
芜湖港	芜湖港储运股份有限公司
大连圣亚旅游控股股份有限公司	大连圣亚旅游控股股份有限公司
大连圣亚	大连圣亚旅游控股股份有限公司
深圳市南光集团股份有限公司	深圳市南光集团股份有限公司
南光集团	深圳市南光集团股份有限公司
山东圣奥化工股份有限公司	山东圣奥化工股份有限公司
山东圣奥	山东圣奥化工股份有限公司
博彦科技股份有限公司	博彦科技股份有限公司
博彦科技	博彦科技股份有限公司
上海安信农业保险股份有限公司	上海安信农业保险股份有限公司
安信农业险	上海安信农业保险股份有限公司
山东山大华特科技股份有限公司	山东山大华特科技股份有限公司
山大华特	山东山大华特科技股份有限公司
浙江佐力药业股份有限公司	浙江佐力药业股份有限公司
佐力药业	浙江佐力药业股份有限公司
法国圣戈班集团	法国圣戈班集团
圣戈班	法国圣戈班集团
烟台杰瑞石油服务集团股份有限公司	烟台杰瑞石油服务集团股份有限公司
杰瑞股份	烟台杰瑞石油服务集团股份有限公司
哈药集团三精制药股份有限公司	哈药集团三精制药股份有限公司
三精制药	哈药集团三精制药股份有限公司
湖北京山轻工机械股份有限公司	湖北京山轻工机械股份有限公司
京山轻机	湖北京山轻工机械股份有限公司
北京银行股份有限公司	北京银行股份有限公司
北京银行	北京银行股份有限公司
民生投资管理股份有限公司	民生投资管理股份有限公司
民生投资	民生投资管理股份有限公司
上海豫园旅游商城股份有限公司	上海豫园旅游商城股份有限公司
豫园商城	上海豫园旅游商城股份有限公司
湖北国创高新材料股份有限公司	湖北国创高新材料股份有限公司
国创高新	湖北国创高新材料股份有限公司
中山大洋电机股份有限公司	中山大洋电机股份有限公司
大洋电机	中山大洋电机股份有限公司
南都网－南方都市报	南都网－南方都市报
南方都市报	南都网－南方都市报
山东华联矿业控股股份有限公司	山东华联矿业控股股份有限公司
华联矿业	山东华联矿业控股股份有限公司
浙江国祥制冷工业股份有限公司	浙江国祥制冷工业股份有限公司
国祥股份	浙江国祥制冷工业股份有限公司
南宁百货大楼股份有限公司	南宁百货大楼股份有限公司
南宁百货	南宁百货大楼股份有限公司
玖龙纸业控股有限公司	玖龙纸业控股有限公司
玖龙纸业	玖龙纸业控股有限公司
卡特彼勒公司	卡特彼勒公司
卡特彼勒	卡特彼勒公司
上海华东电脑股份有限公司	上海华东电脑股份有限公司
华东电脑	上海华东电脑股份有限公司
福陆公司	福陆公司
福陆	福陆公司
济钢集团有限公司	济钢集团有限公司
济钢	济钢集团有限公司
富士康科技集团	富士康科技集团
富士康	富士康科技集团
国信证券股份有限公司	国信证券股份有限公司
国信证券	国信证券股份有限公司
大众理财顾问	大众理财顾问
大众理财顾问	大众理财顾问
深圳发展银行股份有限公司	深圳发展银行股份有限公司
深发展A.*深圳发展银行	深圳发展银行股份有限公司
中国中昌海运股份有限公司	中国中昌海运股份有限公司
ST华龙	中国中昌海运股份有限公司
山东新华制药股份有限公司	山东新华制药股份有限公司
新华制药	山东新华制药股份有限公司
德勤会计师事务所	德勤会计师事务所
德勤	德勤会计师事务所
启明信息技术股份有限公司	启明信息技术股份有限公司
启明信息	启明信息技术股份有限公司
河北建新化工股份有限公司	河北建新化工股份有限公司
建新股份	河北建新化工股份有限公司
东莞勤上光电股份有限公司	东莞勤上光电股份有限公司
勤上光电	东莞勤上光电股份有限公司
福建南平太阳电缆股份有限公司	福建南平太阳电缆股份有限公司
太阳电缆.*南平太阳电缆	福建南平太阳电缆股份有限公司
中国经济周刊	中国经济周刊
中国经济周刊	中国经济周刊
厦门日上车轮集团股份有限公司	厦门日上车轮集团股份有限公司
日上集团	厦门日上车轮集团股份有限公司
山东国瓷功能材料股份有限公司	山东国瓷功能材料股份有限公司
国瓷材料	山东国瓷功能材料股份有限公司
天津劝业场(集团)股份有限公司	天津劝业场(集团)股份有限公司
津劝业	天津劝业场(集团)股份有限公司
上海电气集团股份有限公司	上海电气集团股份有限公司
上海电气	上海电气集团股份有限公司
华视传媒	华视传媒
华视传媒	华视传媒
奥的斯电梯中国投资有限公司	奥的斯电梯中国投资有限公司
奥的斯	奥的斯电梯中国投资有限公司
上海实业医药投资股份有限公司	上海实业医药投资股份有限公司
上实医药	上海实业医药投资股份有限公司
中国第一重型机械股份公司	中国第一重型机械股份公司
中国一重	中国第一重型机械股份公司
潜江永安药业股份有限公司	潜江永安药业股份有限公司
永安药业	潜江永安药业股份有限公司
湖南尔康制药股份有限公司	湖南尔康制药股份有限公司
尔康制药	湖南尔康制药股份有限公司
华泰证券股份有限公司	华泰证券股份有限公司
华泰证券	华泰证券股份有限公司
北京石油交易所	北京石油交易所
北京石油交易所	北京石油交易所
大众汽车股份有限公司	大众汽车股份有限公司
大众汽车	大众汽车股份有限公司
蓝星清洗股份有限公司	蓝星清洗股份有限公司
蓝星清洗	蓝星清洗股份有限公司
上海三毛企业(集团)股份有限公司	上海三毛企业(集团)股份有限公司
上海三毛	上海三毛企业(集团)股份有限公司
华夏典当行有限责任公司	华夏典当行有限责任公司
华夏典当	华夏典当行有限责任公司
广西柳工机械股份有限公司	广西柳工机械股份有限公司
柳工	广西柳工机械股份有限公司
风帆股份有限公司	风帆股份有限公司
风帆股份	风帆股份有限公司
《财经》杂志	《财经》杂志
《财经》杂志	《财经》杂志
广博集团股份有限公司	广博集团股份有限公司
广博股份	广博集团股份有限公司
宁波博威合金材料股份有限公司	宁波博威合金材料股份有限公司
博威合金	宁波博威合金材料股份有限公司
四川天一科技股份有限公司	四川天一科技股份有限公司
天科股份	四川天一科技股份有限公司
益民基金管理有限公司	益民基金管理有限公司
益民基金	益民基金管理有限公司
北京京城机电股份有限公司	北京京城机电股份有限公司
京城股份	北京京城机电股份有限公司
华宸未来基金管理有限公司	华宸未来基金管理有限公司
华宸未来	华宸未来基金管理有限公司
易方达基金管理有限公司	易方达基金管理有限公司
易方达.*易方达基金	易方达基金管理有限公司
上海华谊（集团）公司	上海华谊（集团）公司
华谊集团	上海华谊（集团）公司
广东高乐玩具股份有限公司	广东高乐玩具股份有限公司
高乐股份	广东高乐玩具股份有限公司
四川迪康科技药业股份有限公司	四川迪康科技药业股份有限公司
迪康药业	四川迪康科技药业股份有限公司
广州迪森热能技术股份有限公司	广州迪森热能技术股份有限公司
迪森股份	广州迪森热能技术股份有限公司
东方电气集团东方锅炉股份有限公司	东方电气集团东方锅炉股份有限公司
东方锅炉	东方电气集团东方锅炉股份有限公司
富士重工业株式会社	富士重工业株式会社
富士重工	富士重工业株式会社
深圳市瑞凌实业股份有限公司	深圳市瑞凌实业股份有限公司
瑞凌股份	深圳市瑞凌实业股份有限公司
江苏雅克科技股份有限公司	江苏雅克科技股份有限公司
雅克科技	江苏雅克科技股份有限公司
携程旅行网	携程旅行网
携程	携程旅行网
浙商银行股份有限公司	浙商银行股份有限公司
浙商银行	浙商银行股份有限公司
南昌长力钢铁股份有限公司	南昌长力钢铁股份有限公司
长力股份	南昌长力钢铁股份有限公司
北京住总集团有限责任公司	北京住总集团有限责任公司
住总集团	北京住总集团有限责任公司
中证网	中证网
中证网	中证网
广东宏大爆破股份有限公司	广东宏大爆破股份有限公司
宏大爆破	广东宏大爆破股份有限公司
青岛黄海橡胶股份有限公司	青岛黄海橡胶股份有限公司
黄海股份	青岛黄海橡胶股份有限公司
湖北三峡新型建材股份有限公司	湖北三峡新型建材股份有限公司
三峡新材	湖北三峡新型建材股份有限公司
佳木斯金地造纸股份有限公司	佳木斯金地造纸股份有限公司
佳纸股份	佳木斯金地造纸股份有限公司
深圳市兆驰股份有限公司	深圳市兆驰股份有限公司
兆驰股份	深圳市兆驰股份有限公司
宁波雅戈尔置业有限公司	宁波雅戈尔置业有限公司
雅戈尔置业	宁波雅戈尔置业有限公司
苏州金螳螂建筑装饰股份有限公司	苏州金螳螂建筑装饰股份有限公司
金螳螂	苏州金螳螂建筑装饰股份有限公司
大连商品交易所	大连商品交易所
大商所	大连商品交易所
希努尔男装股份有限公司	希努尔男装股份有限公司
希努尔	希努尔男装股份有限公司
中国联合通信股份有限公司	中国联合通信股份有限公司
中国联通	中国联合通信股份有限公司
中国经营报	中国经营报
中国经营报	中国经营报
上海航铝铝业有限公司	上海航铝铝业有限公司
航铝铝业	上海航铝铝业有限公司
镇江东方电热科技股份有限公司	镇江东方电热科技股份有限公司
东方电热	镇江东方电热科技股份有限公司
丽珠医药集团股份有限公司	丽珠医药集团股份有限公司
丽珠集团	丽珠医药集团股份有限公司
贵研铂业股份有限公司	贵研铂业股份有限公司
贵研铂业	贵研铂业股份有限公司
苏州春兴精工股份有限公司	苏州春兴精工股份有限公司
春兴精工	苏州春兴精工股份有限公司
华润三九医药股份有限公司	华润三九医药股份有限公司
华润三九	华润三九医药股份有限公司
纳爱斯集团	纳爱斯集团
纳爱斯	纳爱斯集团
TCL通讯设备股份有限公司	TCL通讯设备股份有限公司
TCL通讯	TCL通讯设备股份有限公司
郑州新开普电子股份有限公司	郑州新开普电子股份有限公司
新开普	郑州新开普电子股份有限公司
广州白云山制药股份有限公司	广州白云山制药股份有限公司
白云山	广州白云山制药股份有限公司
北京紫竹药业有限公司	北京紫竹药业有限公司
紫竹药业	北京紫竹药业有限公司
江苏舜天股份有限公司	江苏舜天股份有限公司
江苏舜天	江苏舜天股份有限公司
申万巴黎基金管理有限公司	申万巴黎基金管理有限公司
申万巴黎.*申万巴黎基金	申万巴黎基金管理有限公司
福建纳川管材科技股份有限公司	福建纳川管材科技股份有限公司
纳川股份	福建纳川管材科技股份有限公司
江西赣能股份有限公司	江西赣能股份有限公司
赣能股份	江西赣能股份有限公司
TheBoeingCompany	TheBoeingCompany
波音	TheBoeingCompany
宗申产业集团有限公司	宗申产业集团有限公司
宗申集团	宗申产业集团有限公司
GUESS	GUESS
GUESS	GUESS
云南景谷林业股份有限公司	云南景谷林业股份有限公司
景谷林业	云南景谷林业股份有限公司
宝胜科技创新股份有限公司	宝胜科技创新股份有限公司
宝胜股份	宝胜科技创新股份有限公司
英国电信集团	英国电信集团
英国电信	英国电信集团
亨氏食品公司	亨氏食品公司
亨氏	亨氏食品公司
中山大学达安基因股份有限公司	中山大学达安基因股份有限公司
达安基因	中山大学达安基因股份有限公司
浙江东方集团股份有限公司	浙江东方集团股份有限公司
浙江东方	浙江东方集团股份有限公司
广州海鸥卫浴用品股份有限公司	广州海鸥卫浴用品股份有限公司
海鸥卫浴	广州海鸥卫浴用品股份有限公司
海信科龙电器股份有限公司	海信科龙电器股份有限公司
海信科龙	海信科龙电器股份有限公司
海隆石油工业集团	海隆石油工业集团
海隆集团	海隆石油工业集团
数源科技股份有限公司	数源科技股份有限公司
数源科技	数源科技股份有限公司
北京金自天正智能控制股份有限公司	北京金自天正智能控制股份有限公司
金自天正	北京金自天正智能控制股份有限公司
方大锦化化工科技股份有限公司	方大锦化化工科技股份有限公司
方大化工	方大锦化化工科技股份有限公司
拓维信息系统股份有限公司	拓维信息系统股份有限公司
拓维信息	拓维信息系统股份有限公司
甘肃酒钢集团宏兴钢铁股份有限公司	甘肃酒钢集团宏兴钢铁股份有限公司
酒钢宏兴	甘肃酒钢集团宏兴钢铁股份有限公司
国家质检总局网站	国家质检总局网站
国家质检总局网站	国家质检总局网站
南京港股份有限公司	南京港股份有限公司
南京港	南京港股份有限公司
云大科技股份有限公司	云大科技股份有限公司
云大科技	云大科技股份有限公司
北京北陆药业股份有限公司	北京北陆药业股份有限公司
北陆药业	北京北陆药业股份有限公司
AdvancedMicroDevices	AdvancedMicroDevices
AMD	AdvancedMicroDevices
江苏春兰制冷设备股份有限公司	江苏春兰制冷设备股份有限公司
春兰股份.*\\*ST春兰	江苏春兰制冷设备股份有限公司
浙江方正电机股份有限公司	浙江方正电机股份有限公司
方正电机	浙江方正电机股份有限公司
霍尼韦尔公司	霍尼韦尔公司
霍尼韦尔	霍尼韦尔公司
东莞宜安科技股份有限公司	东莞宜安科技股份有限公司
宜安科技	东莞宜安科技股份有限公司
新疆准东石油技术股份有限公司	新疆准东石油技术股份有限公司
准油股份	新疆准东石油技术股份有限公司
中国银联	中国银联
中国银联	中国银联
忠利保险公司	忠利保险公司
忠利保险	忠利保险公司
麦克奥迪（厦门）电气股份有限公司	麦克奥迪（厦门）电气股份有限公司
麦迪电气	麦克奥迪（厦门）电气股份有限公司
永辉超市股份有限公司	永辉超市股份有限公司
永辉超市	永辉超市股份有限公司
杭州滨江房产集团股份有限公司	杭州滨江房产集团股份有限公司
滨江集团	杭州滨江房产集团股份有限公司
中炬高新技术实业(集团)股份有限公司	中炬高新技术实业(集团)股份有限公司
中炬高新	中炬高新技术实业(集团)股份有限公司
岳阳恒立冷气设备股份有限公司	岳阳恒立冷气设备股份有限公司
\\*ST恒立	岳阳恒立冷气设备股份有限公司
山东铝业股份有限公司	山东铝业股份有限公司
山东铝业	山东铝业股份有限公司
柳州化工股份有限公司	柳州化工股份有限公司
柳化股份	柳州化工股份有限公司
青岛港集团有限公司	青岛港集团有限公司
青岛港	青岛港集团有限公司
啤酒	啤酒
趵突泉啤酒	啤酒
浙江金利华电气股份有限公司	浙江金利华电气股份有限公司
金利华电	浙江金利华电气股份有限公司
天马微电子股份有限公司	天马微电子股份有限公司
深天马.*深天马A.*深天马Ａ	天马微电子股份有限公司
江门甘蔗化工厂(集团)股份有限公司	江门甘蔗化工厂(集团)股份有限公司
广东甘化	江门甘蔗化工厂(集团)股份有限公司
西安航空动力股份有限公司	西安航空动力股份有限公司
航空动力	西安航空动力股份有限公司
紫光股份有限公司	紫光股份有限公司
紫光股份	紫光股份有限公司
安徽山鹰纸业股份有限公司	安徽山鹰纸业股份有限公司
山鹰纸业	安徽山鹰纸业股份有限公司
杭州兴源过滤科技股份有限公司	杭州兴源过滤科技股份有限公司
兴源过滤	杭州兴源过滤科技股份有限公司
玲珑集团	玲珑集团
玲珑集团	玲珑集团
西部证券股份有限公司	西部证券股份有限公司
西部证券	西部证券股份有限公司
成都华神集团股份有限公司	成都华神集团股份有限公司
华神集团	成都华神集团股份有限公司
深圳中青宝互动网络股份有限公司	深圳中青宝互动网络股份有限公司
中青宝	深圳中青宝互动网络股份有限公司
安徽科大讯飞信息科技股份有限公司	安徽科大讯飞信息科技股份有限公司
科大讯飞	安徽科大讯飞信息科技股份有限公司
贵州盘江精煤股份有限公司	贵州盘江精煤股份有限公司
盘江股份	贵州盘江精煤股份有限公司
通化东宝药业股份有限公司	通化东宝药业股份有限公司
通化东宝	通化东宝药业股份有限公司
中国第一重型机械集团公司	中国第一重型机械集团公司
一重	中国第一重型机械集团公司
山东矿机集团股份有限公司	山东矿机集团股份有限公司
山东矿机	山东矿机集团股份有限公司
天津泰达集团有限公司	天津泰达集团有限公司
泰达集团	天津泰达集团有限公司
河南大有能源股份有限公司	河南大有能源股份有限公司
大有能源	河南大有能源股份有限公司
中国人寿保险集团公司	中国人寿保险集团公司
中国人寿保险公司	中国人寿保险集团公司
浙江盾安人工环境股份有限公司	浙江盾安人工环境股份有限公司
盾安环境	浙江盾安人工环境股份有限公司
浙江新嘉联电子股份有限公司	浙江新嘉联电子股份有限公司
新嘉联	浙江新嘉联电子股份有限公司
德国商业银行	德国商业银行
德国商业银行	德国商业银行
福建兄弟集团有限公司	福建兄弟集团有限公司
福建兄弟	福建兄弟集团有限公司
星美国际集团有限公司	星美国际集团有限公司
星美国际	星美国际集团有限公司
康奈集团有限公司	康奈集团有限公司
康奈集团	康奈集团有限公司
江苏阳光集团	江苏阳光集团
阳光集团	江苏阳光集团
中航国际租赁有限公司	中航国际租赁有限公司
中航租赁	中航国际租赁有限公司
上海新黄浦置业股份有限公司	上海新黄浦置业股份有限公司
新黄浦	上海新黄浦置业股份有限公司
尤洛卡矿业安全工程股份有限公司	尤洛卡矿业安全工程股份有限公司
尤洛卡	尤洛卡矿业安全工程股份有限公司
中国电信集团公司	中国电信集团公司
中国电信	中国电信集团公司
吉林高速公路股份有限公司	吉林高速公路股份有限公司
吉林高速	吉林高速公路股份有限公司
深圳新都酒店股份有限公司	深圳新都酒店股份有限公司
新都酒店	深圳新都酒店股份有限公司
美国万宝盛华公司	美国万宝盛华公司
万宝盛华	美国万宝盛华公司
南京汽车集团有限公司	南京汽车集团有限公司
南京汽车.*南汽集团	南京汽车集团有限公司
北京宝瑞通典当行有限责任公司	北京宝瑞通典当行有限责任公司
宝瑞通	北京宝瑞通典当行有限责任公司
深圳市腾邦国际商业服务股份有限公司	深圳市腾邦国际商业服务股份有限公司
腾邦国际	深圳市腾邦国际商业服务股份有限公司
TheCarlyleGroup	TheCarlyleGroup
凯雷	TheCarlyleGroup
深圳世联行地产顾问股份有限公司	深圳世联行地产顾问股份有限公司
世联行	深圳世联行地产顾问股份有限公司
张家港化工机械股份有限公司	张家港化工机械股份有限公司
张化机	张家港化工机械股份有限公司
烟台冰轮股份有限公司	烟台冰轮股份有限公司
烟台冰轮	烟台冰轮股份有限公司
三安光电股份有限公司	三安光电股份有限公司
三安光电	三安光电股份有限公司
阳光电源股份有限公司	阳光电源股份有限公司
阳光电源	阳光电源股份有限公司
大陆希望集团	大陆希望集团
希望集团	大陆希望集团
新日本制铁公司	新日本制铁公司
新日铁	新日本制铁公司
南方香江集团有限公司	南方香江集团有限公司
香江集团	南方香江集团有限公司
上海新朋实业股份有限公司	上海新朋实业股份有限公司
新朋股份	上海新朋实业股份有限公司
中化国际控股股份有限公司	中化国际控股股份有限公司
中化国际	中化国际控股股份有限公司
珠海和佳医疗设备股份有限公司	珠海和佳医疗设备股份有限公司
和佳股份	珠海和佳医疗设备股份有限公司
中国大连国际合作（集团）股份有限公司	中国大连国际合作（集团）股份有限公司
大连国际	中国大连国际合作（集团）股份有限公司
浙江精功科技股份有限公司	浙江精功科技股份有限公司
精功科技	浙江精功科技股份有限公司
太平洋国际拍卖有限公司	太平洋国际拍卖有限公司
太平洋国际拍卖	太平洋国际拍卖有限公司
中国抚州网	中国抚州网
中国抚州网	中国抚州网
成都市兴蓉投资股份有限公司	成都市兴蓉投资股份有限公司
兴蓉投资	成都市兴蓉投资股份有限公司
广西花红药业股份有限公司	广西花红药业股份有限公司
花红药业	广西花红药业股份有限公司
湖南洞庭水殖股份有限公司	湖南洞庭水殖股份有限公司
洞庭水殖	湖南洞庭水殖股份有限公司
任子行网络技术股份有限公司	任子行网络技术股份有限公司
任子行	任子行网络技术股份有限公司
厦门象屿股份有限公司	厦门象屿股份有限公司
象屿股份	厦门象屿股份有限公司
长春百货大楼集团股份有限公司	长春百货大楼集团股份有限公司
长百集团	长春百货大楼集团股份有限公司
四川沱牌舍得酒业股份有限公司	四川沱牌舍得酒业股份有限公司
沱牌舍得	四川沱牌舍得酒业股份有限公司
山东登海种业股份有限公司	山东登海种业股份有限公司
登海种业	山东登海种业股份有限公司
金龙铜管集团	金龙铜管集团
金龙铜管	金龙铜管集团
北京顺鑫农业股份有限公司	北京顺鑫农业股份有限公司
顺鑫农业	北京顺鑫农业股份有限公司
江苏华昌化工股份有限公司	江苏华昌化工股份有限公司
华昌化工	江苏华昌化工股份有限公司
步步高	步步高
步步高	步步高
江西赣粤高速公路股份有限公司	江西赣粤高速公路股份有限公司
赣粤高速	江西赣粤高速公路股份有限公司
上海龙头(集团)股份有限公司	上海龙头(集团)股份有限公司
龙头股份	上海龙头(集团)股份有限公司
国华人寿保险股份有限公司	国华人寿保险股份有限公司
国华人寿	国华人寿保险股份有限公司
青岛天泰集团股份有限公司	青岛天泰集团股份有限公司
青岛天泰	青岛天泰集团股份有限公司
空中客车公司	空中客车公司
空中客车	空中客车公司
内蒙古福瑞医疗科技股份有限公司	内蒙古福瑞医疗科技股份有限公司
福瑞股份	内蒙古福瑞医疗科技股份有限公司
深圳市零七股份有限公司	深圳市零七股份有限公司
零七股份	深圳市零七股份有限公司
厦门海洋实业(集团)股份有限公司	厦门海洋实业(集团)股份有限公司
海洋集团	厦门海洋实业(集团)股份有限公司
中科英华高技术股份有限公司	中科英华高技术股份有限公司
中科英华	中科英华高技术股份有限公司
南京普天通信股份有限公司	南京普天通信股份有限公司
南京普天.*宁通信Ｂ	南京普天通信股份有限公司
上海汇通能源股份有限公司	上海汇通能源股份有限公司
汇通能源	上海汇通能源股份有限公司
河南安彩高科股份有限公司	河南安彩高科股份有限公司
安彩高科	河南安彩高科股份有限公司
四川圣达实业股份有限公司	四川圣达实业股份有限公司
四川圣达	四川圣达实业股份有限公司
广东大华农动物保健品股份有限公司	广东大华农动物保健品股份有限公司
大华农	广东大华农动物保健品股份有限公司
河南佰利联化学股份有限公司	河南佰利联化学股份有限公司
佰利联	河南佰利联化学股份有限公司
青岛五洲大药房有限公司	青岛五洲大药房有限公司
五洲大药房	青岛五洲大药房有限公司
杭州汽轮动力集团有限公司	杭州汽轮动力集团有限公司
杭州汽轮	杭州汽轮动力集团有限公司
江西煌上煌集团食品股份有限公司	江西煌上煌集团食品股份有限公司
煌上煌	江西煌上煌集团食品股份有限公司
物产中拓股份有限公司	物产中拓股份有限公司
物产中拓	物产中拓股份有限公司
德尔国际家居股份有限公司	德尔国际家居股份有限公司
德尔家居	德尔国际家居股份有限公司
宁夏建材集团股份有限公司	宁夏建材集团股份有限公司
宁夏建材	宁夏建材集团股份有限公司
峨眉山旅游股份有限公司	峨眉山旅游股份有限公司
峨眉旅游.*峨眉山Ａ	峨眉山旅游股份有限公司
厚朴基金管理公司	厚朴基金管理公司
厚朴	厚朴基金管理公司
中顺洁柔纸业股份有限公司	中顺洁柔纸业股份有限公司
中顺洁柔	中顺洁柔纸业股份有限公司
北京华旗资讯数码科技发展有限公司	北京华旗资讯数码科技发展有限公司
爱国者	北京华旗资讯数码科技发展有限公司
阳泉煤业(集团)股份有限公司	阳泉煤业(集团)股份有限公司
阳泉煤业	阳泉煤业(集团)股份有限公司
杭州中瑞思创科技股份有限公司	杭州中瑞思创科技股份有限公司
中瑞思创	杭州中瑞思创科技股份有限公司
川化股份有限公司	川化股份有限公司
川化股份	川化股份有限公司
河南新大新材料股份有限公司	河南新大新材料股份有限公司
新大新材	河南新大新材料股份有限公司
北京晚报	北京晚报
北京晚报	北京晚报
云南驰宏锌锗股份有限公司	云南驰宏锌锗股份有限公司
驰宏锌锗	云南驰宏锌锗股份有限公司
中化国际(控股)股份有限公司	中化国际(控股)股份有限公司
中化国际	中化国际(控股)股份有限公司
金融界网络信息技术有限公司	金融界网络信息技术有限公司
金融界	金融界网络信息技术有限公司
惠而浦公司	惠而浦公司
惠而浦	惠而浦公司
浙江杭州鑫富药业股份有限公司	浙江杭州鑫富药业股份有限公司
鑫富药业	浙江杭州鑫富药业股份有限公司
德国意昂集团	德国意昂集团
意昂	德国意昂集团
四川金顶(集团)股份有限公司	四川金顶(集团)股份有限公司
四川金顶	四川金顶(集团)股份有限公司
上海熊猫乳品有限公司	上海熊猫乳品有限公司
上海熊猫乳品有限公司	上海熊猫乳品有限公司
宁波富达股份有限公司	宁波富达股份有限公司
宁波富达	宁波富达股份有限公司
北京鼎成典当行有限公司	北京鼎成典当行有限公司
鼎成典当	北京鼎成典当行有限公司
天通控股股份有限公司	天通控股股份有限公司
天通股份	天通控股股份有限公司
四川省山野生物科技有限公司	四川省山野生物科技有限公司
山野生物	四川省山野生物科技有限公司
浙江维康药业有限公司	浙江维康药业有限公司
浙江维康	浙江维康药业有限公司
浙江我武生物科技股份有限公司	浙江我武生物科技股份有限公司
我武生物	浙江我武生物科技股份有限公司
标准普尔	标准普尔
标准普尔	标准普尔
朝华科技集团股份有限公司	朝华科技集团股份有限公司
S\\*ST朝华	朝华科技集团股份有限公司
上实地产	上实地产
上实地产	上实地产
首席财务官	首席财务官
首席财务官	首席财务官
南京钢铁股份有限公司	南京钢铁股份有限公司
南钢股份	南京钢铁股份有限公司
华油惠博普科技股份有限公司	华油惠博普科技股份有限公司
惠博普	华油惠博普科技股份有限公司
上海新文化传媒集团股份有限公司	上海新文化传媒集团股份有限公司
新文化	上海新文化传媒集团股份有限公司
银泰控股股份有限公司	银泰控股股份有限公司
银泰股份	银泰控股股份有限公司
深圳市深宝实业股份有限公司	深圳市深宝实业股份有限公司
深深宝.*深深宝A.*深深宝Ａ	深圳市深宝实业股份有限公司
绿都控股集团有限公司	绿都控股集团有限公司
绿都房产	绿都控股集团有限公司
通化钢铁集团公司	通化钢铁集团公司
通化钢铁.*通钢集团	通化钢铁集团公司
广东华圣科技投资股份有限公司	广东华圣科技投资股份有限公司
华圣科技	广东华圣科技投资股份有限公司
每日新报	每日新报
每日新报	每日新报
江苏炎黄在线物流股份有限公司	江苏炎黄在线物流股份有限公司
炎黄物流	江苏炎黄在线物流股份有限公司
福建漳州发展股份有限公司	福建漳州发展股份有限公司
漳州发展	福建漳州发展股份有限公司
陕西秦川机械发展股份有限公司	陕西秦川机械发展股份有限公司
秦川发展	陕西秦川机械发展股份有限公司
百隆东方股份有限公司	百隆东方股份有限公司
百隆东方	百隆东方股份有限公司
中国光大集团	中国光大集团
光大集团	中国光大集团
重庆三峡水利电力(集团)股份有限公司	重庆三峡水利电力(集团)股份有限公司
三峡水利	重庆三峡水利电力(集团)股份有限公司
北京中科金财科技股份有限公司	北京中科金财科技股份有限公司
中科金财	北京中科金财科技股份有限公司
华懋集团公司	华懋集团公司
华懋集团	华懋集团公司
中国第一汽车集团公司	中国第一汽车集团公司
中国一汽	中国第一汽车集团公司
宁波东力股份有限公司	宁波东力股份有限公司
宁波东力	宁波东力股份有限公司
唐山三友化工股份有限公司	唐山三友化工股份有限公司
三友化工	唐山三友化工股份有限公司
中国石化胜利油田大明(集团)股份有限公司	中国石化胜利油田大明(集团)股份有限公司
石油大明	中国石化胜利油田大明(集团)股份有限公司
九芝堂股份有限公司	九芝堂股份有限公司
九芝堂	九芝堂股份有限公司
沧州明珠塑料股份有限公司	沧州明珠塑料股份有限公司
沧州明珠	沧州明珠塑料股份有限公司
中粮生物化学（安徽）股份有限公司	中粮生物化学（安徽）股份有限公司
中粮生化	中粮生物化学（安徽）股份有限公司
太原化工股份有限公司	太原化工股份有限公司
太化股份	太原化工股份有限公司
江苏中天科技股份有限公司	江苏中天科技股份有限公司
中天科技	江苏中天科技股份有限公司
武汉塑料工业集团股份有限公司	武汉塑料工业集团股份有限公司
武汉塑料	武汉塑料工业集团股份有限公司
上海金枫酒业股份有限公司	上海金枫酒业股份有限公司
金枫酒业	上海金枫酒业股份有限公司
深圳市美盈森环保科技股份有限公司	深圳市美盈森环保科技股份有限公司
美盈森	深圳市美盈森环保科技股份有限公司
沃尔沃公司	沃尔沃公司
沃尔沃	沃尔沃公司
浙江众成包装材料股份有限公司	浙江众成包装材料股份有限公司
浙江众成	浙江众成包装材料股份有限公司
合肥百货大楼集团股份有限公司	合肥百货大楼集团股份有限公司
合肥百货	合肥百货大楼集团股份有限公司
安徽国元信托有限责任公司	安徽国元信托有限责任公司
国元信托	安徽国元信托有限责任公司
重庆三峡水利电力集团股份有限公司	重庆三峡水利电力集团股份有限公司
三峡水利	重庆三峡水利电力集团股份有限公司
合肥城建发展股份有限公司	合肥城建发展股份有限公司
合肥城建	合肥城建发展股份有限公司
江苏高淳陶瓷股份有限公司	江苏高淳陶瓷股份有限公司
高淳陶瓷	江苏高淳陶瓷股份有限公司
南京云海特种金属股份有限公司	南京云海特种金属股份有限公司
云海金属	南京云海特种金属股份有限公司
中国劳动保障报	中国劳动保障报
中国劳动保障报	中国劳动保障报
蓝盾信息安全技术股份有限公司	蓝盾信息安全技术股份有限公司
蓝盾股份	蓝盾信息安全技术股份有限公司
广东生益科技股份有限公司	广东生益科技股份有限公司
生益科技	广东生益科技股份有限公司
红塔烟草（集团）有限责任公司	红塔烟草（集团）有限责任公司
红塔集团	红塔烟草（集团）有限责任公司
北京首都开发股份有限公司	北京首都开发股份有限公司
首开股份	北京首都开发股份有限公司
安徽桑乐金股份有限公司	安徽桑乐金股份有限公司
桑乐金	安徽桑乐金股份有限公司
厦门银鹭集团	厦门银鹭集团
银鹭	厦门银鹭集团
华润创业有限公司	华润创业有限公司
华润创业	华润创业有限公司
武汉道博股份有限公司	武汉道博股份有限公司
道博股份	武汉道博股份有限公司
国际商业机器公司	国际商业机器公司
IBM	国际商业机器公司
武汉东湖高新集团股份有限公司	武汉东湖高新集团股份有限公司
东湖高新	武汉东湖高新集团股份有限公司
正德人寿保险股份有限公司	正德人寿保险股份有限公司
正德人寿	正德人寿保险股份有限公司
齐二机床集团有限公司	齐二机床集团有限公司
齐二机床	齐二机床集团有限公司
山东沃华医药科技股份有限公司	山东沃华医药科技股份有限公司
沃华医药	山东沃华医药科技股份有限公司
中信基金管理有限责任公司	中信基金管理有限责任公司
中信基金	中信基金管理有限责任公司
大德传媒股份有限公司	大德传媒股份有限公司
大德传媒	大德传媒股份有限公司
上海新华传媒股份有限公司	上海新华传媒股份有限公司
新华传媒	上海新华传媒股份有限公司
美国联合技术公司	美国联合技术公司
联合技术	美国联合技术公司
浙江东晶电子股份有限公司	浙江东晶电子股份有限公司
东晶电子	浙江东晶电子股份有限公司
河北津西钢铁股份有限公司	河北津西钢铁股份有限公司
津西钢铁	河北津西钢铁股份有限公司
唐山钢铁股份有限公司	唐山钢铁股份有限公司
唐山钢铁	唐山钢铁股份有限公司
宏达高科控股股份有限公司	宏达高科控股股份有限公司
宏达高科	宏达高科控股股份有限公司
沈阳网	沈阳网
沈阳网	沈阳网
深圳诺普信农化股份有限公司	深圳诺普信农化股份有限公司
诺普信	深圳诺普信农化股份有限公司
宁夏东方钽业股份有限公司	宁夏东方钽业股份有限公司
东方钽业	宁夏东方钽业股份有限公司
青岛澳柯玛股份有限公司	青岛澳柯玛股份有限公司
澳柯玛	青岛澳柯玛股份有限公司
贵州赤天化股份有限公司	贵州赤天化股份有限公司
赤天化	贵州赤天化股份有限公司
康菲石油公司	康菲石油公司
康菲石油公司	康菲石油公司
马士基集团	马士基集团
马士基集团	马士基集团
昆明百货大楼(集团)股份有限公司	昆明百货大楼(集团)股份有限公司
昆百大.*昆百大Ａ	昆明百货大楼(集团)股份有限公司
北人印刷机械股份有限公司	北人印刷机械股份有限公司
北人股份	北人印刷机械股份有限公司
中钢集团安徽天源科技股份有限公司	中钢集团安徽天源科技股份有限公司
中钢天源	中钢集团安徽天源科技股份有限公司
美国太阳石油公司	美国太阳石油公司
太阳石油	美国太阳石油公司
美盛文化创意股份有限公司	美盛文化创意股份有限公司
美盛文化	美盛文化创意股份有限公司
贵州茅台酒股份有限公司	贵州茅台酒股份有限公司
贵州茅台	贵州茅台酒股份有限公司
芝加哥商业交易所	芝加哥商业交易所
芝加哥商业交易所	芝加哥商业交易所
上海新阳半导体材料股份有限公司	上海新阳半导体材料股份有限公司
上海新阳	上海新阳半导体材料股份有限公司
北京空港科技园区股份有限公司	北京空港科技园区股份有限公司
空港股份	北京空港科技园区股份有限公司
山东鲁信高新技术产业股份有限公司	山东鲁信高新技术产业股份有限公司
鲁信高新	山东鲁信高新技术产业股份有限公司
哈尔滨光宇集团股份有限公司	哈尔滨光宇集团股份有限公司
光宇集团	哈尔滨光宇集团股份有限公司
浙江万马电缆股份有限公司	浙江万马电缆股份有限公司
万马电缆	浙江万马电缆股份有限公司
伊藤忠综合贸易公司	伊藤忠综合贸易公司
伊藤忠	伊藤忠综合贸易公司
中炬高新技术实业集团股份有限公司	中炬高新技术实业集团股份有限公司
中炬高新	中炬高新技术实业集团股份有限公司
四川升达林业产业股份有限公司	四川升达林业产业股份有限公司
升达林业	四川升达林业产业股份有限公司
中信泰富有限公司	中信泰富有限公司
中信泰富	中信泰富有限公司
杭州锅炉集团股份有限公司	杭州锅炉集团股份有限公司
杭锅股份	杭州锅炉集团股份有限公司
TheWaltDisneyCompany	TheWaltDisneyCompany
迪士尼	TheWaltDisneyCompany
济南钢铁股份有限公司	济南钢铁股份有限公司
济南钢铁	济南钢铁股份有限公司
安徽新华传媒股份有限公司	安徽新华传媒股份有限公司
皖新传媒	安徽新华传媒股份有限公司
乐视网信息技术（北京）股份有限公司	乐视网信息技术（北京）股份有限公司
乐视网	乐视网信息技术（北京）股份有限公司
深圳市朗科科技股份有限公司	深圳市朗科科技股份有限公司
朗科科技	深圳市朗科科技股份有限公司
中油金鸿能源投资股份有限公司	中油金鸿能源投资股份有限公司
金鸿能源	中油金鸿能源投资股份有限公司
利亚德光电股份有限公司	利亚德光电股份有限公司
利亚德	利亚德光电股份有限公司
包头华资实业股份有限公司	包头华资实业股份有限公司
华资实业	包头华资实业股份有限公司
上海丰华(集团)股份有限公司	上海丰华(集团)股份有限公司
丰华股份	上海丰华(集团)股份有限公司
大众交通集团股份有限公司	大众交通集团股份有限公司
大众交通	大众交通集团股份有限公司
正泰集团	正泰集团
正泰集团	正泰集团
新疆西部牧业股份有限公司	新疆西部牧业股份有限公司
西部牧业	新疆西部牧业股份有限公司
广东猛狮电源科技股份有限公司	广东猛狮电源科技股份有限公司
猛狮科技	广东猛狮电源科技股份有限公司
浙江浙能电力股份有限公司	浙江浙能电力股份有限公司
浙能电力	浙江浙能电力股份有限公司
深圳航空有限责任公司	深圳航空有限责任公司
深圳航空	深圳航空有限责任公司
东华能源股份有限公司	东华能源股份有限公司
东华能源	东华能源股份有限公司
黄石东贝机电集团有限责任公司	黄石东贝机电集团有限责任公司
东贝集团	黄石东贝机电集团有限责任公司
浙江医药股份有限公司	浙江医药股份有限公司
浙江医药	浙江医药股份有限公司
南通锻压设备股份有限公司	南通锻压设备股份有限公司
南通锻压	南通锻压设备股份有限公司
中通客车控股股份有限公司	中通客车控股股份有限公司
中通客车	中通客车控股股份有限公司
中国海洋石油有限公司	中国海洋石油有限公司
中国海洋石油	中国海洋石油有限公司
湖南江南红箭股份有限公司	湖南江南红箭股份有限公司
江南红箭	湖南江南红箭股份有限公司
中国中央电视台	中国中央电视台
中央电视台	中国中央电视台
佛山电器照明股份有限公司	佛山电器照明股份有限公司
佛山照明	佛山电器照明股份有限公司
上海烟草（集团）公司	上海烟草（集团）公司
上海烟草	上海烟草（集团）公司
浙江万安科技股份有限公司	浙江万安科技股份有限公司
万安科技	浙江万安科技股份有限公司
重庆万里新能源股份有限公司	重庆万里新能源股份有限公司
万里股份	重庆万里新能源股份有限公司
万向钱潮股份有限公司	万向钱潮股份有限公司
万向钱潮	万向钱潮股份有限公司
陇西县清吉洋芋开发有限责任公司	陇西县清吉洋芋开发有限责任公司
清吉洋芋	陇西县清吉洋芋开发有限责任公司
南方新闻网	南方新闻网
南方网	南方新闻网
中国玻纤股份有限公司	中国玻纤股份有限公司
中国玻纤	中国玻纤股份有限公司
山西兰花科技创业股份有限公司	山西兰花科技创业股份有限公司
兰花科创	山西兰花科技创业股份有限公司
上海中路（集团）有限公司	上海中路（集团）有限公司
中路集团	上海中路（集团）有限公司
苏州纽威阀门股份有限公司	苏州纽威阀门股份有限公司
纽威股份	苏州纽威阀门股份有限公司
河南明泰铝业股份有限公司	河南明泰铝业股份有限公司
明泰铝业	河南明泰铝业股份有限公司
北京中创信测科技股份有限公司	北京中创信测科技股份有限公司
中创信测	北京中创信测科技股份有限公司
赛轮股份有限公司	赛轮股份有限公司
赛轮股份	赛轮股份有限公司
哈尔滨誉衡药业股份有限公司	哈尔滨誉衡药业股份有限公司
誉衡药业	哈尔滨誉衡药业股份有限公司
长沙开元仪器股份有限公司	长沙开元仪器股份有限公司
开元仪器	长沙开元仪器股份有限公司
珠海格力电器股份有限公司	珠海格力电器股份有限公司
格力电器	珠海格力电器股份有限公司
富士通集团（FujitsuLimited）	富士通集团（FujitsuLimited）
富士通	富士通集团（FujitsuLimited）
中国东方航空股份有限公司	中国东方航空股份有限公司
东方航空	中国东方航空股份有限公司
鲁花集团	鲁花集团
鲁花集团	鲁花集团
华西都市报	华西都市报
华西都市报	华西都市报
北京控股有限公司	北京控股有限公司
北京控股	北京控股有限公司
宁波银行股份有限公司	宁波银行股份有限公司
宁波银行	宁波银行股份有限公司
杭州汽轮机股份有限公司	杭州汽轮机股份有限公司
杭汽轮.*杭汽轮Ｂ	杭州汽轮机股份有限公司
山西仟源制药股份有限公司	山西仟源制药股份有限公司
仟源制药	山西仟源制药股份有限公司
PRADA	PRADA
Prada	PRADA
天津医药集团	天津医药集团
天津医药	天津医药集团
聚光科技（杭州）股份有限公司	聚光科技（杭州）股份有限公司
聚光科技	聚光科技（杭州）股份有限公司
瑞士诺华公司	瑞士诺华公司
瑞士诺华公司	瑞士诺华公司
浙江爱仕达电器股份有限公司	浙江爱仕达电器股份有限公司
爱仕达	浙江爱仕达电器股份有限公司
赤峰吉隆黄金矿业股份有限公司	赤峰吉隆黄金矿业股份有限公司
赤峰黄金	赤峰吉隆黄金矿业股份有限公司
深圳市彩虹精细化工股份有限公司	深圳市彩虹精细化工股份有限公司
彩虹精化	深圳市彩虹精细化工股份有限公司
无锡双象超纤材料股份有限公司	无锡双象超纤材料股份有限公司
双象股份	无锡双象超纤材料股份有限公司
上海梅林正广和股份有限公司	上海梅林正广和股份有限公司
上海梅林	上海梅林正广和股份有限公司
博士伦	博士伦
博士伦	博士伦
广东风华高新科技股份有限公司	广东风华高新科技股份有限公司
风华高科	广东风华高新科技股份有限公司
福建龙净环保股份有限公司	福建龙净环保股份有限公司
龙净环保	福建龙净环保股份有限公司
美国联合通讯社	美国联合通讯社
美联社	美国联合通讯社
重庆新世纪游轮股份有限公司	重庆新世纪游轮股份有限公司
世纪游轮	重庆新世纪游轮股份有限公司
广东精艺金属股份有限公司	广东精艺金属股份有限公司
精艺股份.*精艺金属	广东精艺金属股份有限公司
七台河宝泰隆煤化工股份有限公司	七台河宝泰隆煤化工股份有限公司
宝泰隆	七台河宝泰隆煤化工股份有限公司
东吴基金管理有限公司	东吴基金管理有限公司
东吴基金	东吴基金管理有限公司
鸿达兴业股份有限公司	鸿达兴业股份有限公司
鸿达兴业	鸿达兴业股份有限公司
福特汽车公司	福特汽车公司
福特汽车	福特汽车公司
株洲冶炼集团股份有限公司	株洲冶炼集团股份有限公司
株冶集团	株洲冶炼集团股份有限公司
中国嘉陵工业股份有限公司集团	中国嘉陵工业股份有限公司集团
中国嘉陵	中国嘉陵工业股份有限公司集团
山西华康药业集团股份有限公司	山西华康药业集团股份有限公司
华康药业	山西华康药业集团股份有限公司
金地(集团)股份有限公司	金地(集团)股份有限公司
金地集团	金地(集团)股份有限公司
东软集团股份有限公司	东软集团股份有限公司
东软集团	东软集团股份有限公司
中国铁建股份有限公司	中国铁建股份有限公司
中国铁建	中国铁建股份有限公司
SunMicrosystems,Inc.	SunMicrosystems,Inc.
SUN	SunMicrosystems,Inc.
上海航天汽车机电股份有限公司	上海航天汽车机电股份有限公司
航天机电	上海航天汽车机电股份有限公司
河南新飞电器（集团）股份有限公司	河南新飞电器（集团）股份有限公司
新飞电器	河南新飞电器（集团）股份有限公司
中国新闻社	中国新闻社
中新社	中国新闻社
内蒙古亿利能源股份有限公司	内蒙古亿利能源股份有限公司
亿利能源	内蒙古亿利能源股份有限公司
骅威科技股份有限公司	骅威科技股份有限公司
骅威股份	骅威科技股份有限公司
山东宝莫生物化工股份有限公司	山东宝莫生物化工股份有限公司
宝莫股份	山东宝莫生物化工股份有限公司
大红鹰集团	大红鹰集团
大红鹰	大红鹰集团
山东宏达矿业股份有限公司	山东宏达矿业股份有限公司
宏达矿业	山东宏达矿业股份有限公司
江苏三友集团股份有限公司	江苏三友集团股份有限公司
江苏三友	江苏三友集团股份有限公司
东方证券股份有限公司	东方证券股份有限公司
东方证券	东方证券股份有限公司
佳能公司	佳能公司
佳能	佳能公司
上海中技投资控股股份有限公司	上海中技投资控股股份有限公司
中技控股	上海中技投资控股股份有限公司
海鑫钢铁集团有限公司	海鑫钢铁集团有限公司
海鑫钢铁	海鑫钢铁集团有限公司
利尔化学股份有限公司	利尔化学股份有限公司
利尔化学	利尔化学股份有限公司
中电集团	中电集团
中电集团	中电集团
中粮地产（集团）股份有限公司	中粮地产（集团）股份有限公司
中粮地产	中粮地产（集团）股份有限公司
中国大连国际合作(集团)股份有限公司	中国大连国际合作(集团)股份有限公司
大连国际	中国大连国际合作(集团)股份有限公司
四川丹甫制冷压缩机股份有限公司	四川丹甫制冷压缩机股份有限公司
丹甫股份	四川丹甫制冷压缩机股份有限公司
江西联创光电科技股份有限公司	江西联创光电科技股份有限公司
联创光电	江西联创光电科技股份有限公司
新疆天康畜牧生物技术股份有限公司	新疆天康畜牧生物技术股份有限公司
天康生物	新疆天康畜牧生物技术股份有限公司
徐州矿务集团有限公司	徐州矿务集团有限公司
徐矿集团	徐州矿务集团有限公司
大唐国际发电股份有限公司	大唐国际发电股份有限公司
大唐发电	大唐国际发电股份有限公司
杭州开元房地产集团有限公司	杭州开元房地产集团有限公司
开元房产	杭州开元房地产集团有限公司
海南珠江控股股份有限公司	海南珠江控股股份有限公司
珠江控股.*\\*ST珠江	海南珠江控股股份有限公司
山西百圆裤业连锁经营股份有限公司	山西百圆裤业连锁经营股份有限公司
百圆裤业	山西百圆裤业连锁经营股份有限公司
上海交运集团股份有限公司	上海交运集团股份有限公司
交运股份	上海交运集团股份有限公司
上海万业企业股份有限公司	上海万业企业股份有限公司
万业企业	上海万业企业股份有限公司
麦肯锡咨询公司	麦肯锡咨询公司
麦肯锡	麦肯锡咨询公司
上海华源股份有限公司	上海华源股份有限公司
\\*ST华源	上海华源股份有限公司
山东瑞康医药股份有限公司	山东瑞康医药股份有限公司
瑞康医药	山东瑞康医药股份有限公司
新疆塔里木农业综合开发股份有限公司	新疆塔里木农业综合开发股份有限公司
新农开发	新疆塔里木农业综合开发股份有限公司
国电南京自动化股份有限公司	国电南京自动化股份有限公司
国电南自	国电南京自动化股份有限公司
深圳证券交易所	深圳证券交易所
深交所	深圳证券交易所
陕西坚瑞消防股份有限公司	陕西坚瑞消防股份有限公司
坚瑞消防	陕西坚瑞消防股份有限公司
北京华联商厦股份有限公司	北京华联商厦股份有限公司
华联股份	北京华联商厦股份有限公司
青岛金王应用化学股份有限公司	青岛金王应用化学股份有限公司
青岛金王	青岛金王应用化学股份有限公司
上海宏泉集团有限公司	上海宏泉集团有限公司
宏泉集团	上海宏泉集团有限公司
北京湘鄂情股份有限公司	北京湘鄂情股份有限公司
湘鄂情	北京湘鄂情股份有限公司
龙虎网	龙虎网
龙虎网	龙虎网
荣成华泰汽车有限公司	荣成华泰汽车有限公司
华泰集团	荣成华泰汽车有限公司
中国中化集团公司	中国中化集团公司
中化集团	中国中化集团公司
昆明制药集团股份有限公司	昆明制药集团股份有限公司
昆明制药	昆明制药集团股份有限公司
南通江海电容器股份有限公司	南通江海电容器股份有限公司
江海股份.*南通江海	南通江海电容器股份有限公司
汕头宏业(集团)股份有限公司	汕头宏业(集团)股份有限公司
宏业集团	汕头宏业(集团)股份有限公司
新疆天润乳业股份有限公司	新疆天润乳业股份有限公司
天润乳业	新疆天润乳业股份有限公司
中信海洋直升机股份有限公司	中信海洋直升机股份有限公司
中信海直	中信海洋直升机股份有限公司
通策医疗投资股份有限公司	通策医疗投资股份有限公司
通策医疗	通策医疗投资股份有限公司
江苏弘业股份有限公司	江苏弘业股份有限公司
弘业股份	江苏弘业股份有限公司
台湾润博集团	台湾润博集团
润博	台湾润博集团
山东滨州渤海活塞股份有限公司	山东滨州渤海活塞股份有限公司
渤海活塞.*滨州活塞	山东滨州渤海活塞股份有限公司
北京湘鄂情集团股份有限公司	北京湘鄂情集团股份有限公司
湘鄂情	北京湘鄂情集团股份有限公司
上海东方典当有限公司	上海东方典当有限公司
东方典当	上海东方典当有限公司
穆迪	穆迪
穆迪	穆迪
南方报业传媒集团	南方报业传媒集团
南方报业	南方报业传媒集团
中国全聚德集团股份有限公司	中国全聚德集团股份有限公司
全聚德	中国全聚德集团股份有限公司
广东德联集团股份有限公司	广东德联集团股份有限公司
德联集团	广东德联集团股份有限公司
中国神华能源股份有限公司	中国神华能源股份有限公司
中国神华	中国神华能源股份有限公司
陕西精密合金股份有限公司	陕西精密合金股份有限公司
精密股份	陕西精密合金股份有限公司
焦点科技股份有限公司	焦点科技股份有限公司
焦点科技	焦点科技股份有限公司
宁波建工股份有限公司	宁波建工股份有限公司
宁波建工	宁波建工股份有限公司
中国平安保险(集团)股份有限公司	中国平安保险(集团)股份有限公司
中国平安	中国平安保险(集团)股份有限公司
湖北福星科技股份有限公司	湖北福星科技股份有限公司
福星股份.*福星科技	湖北福星科技股份有限公司
重庆百货大楼股份有限公司	重庆百货大楼股份有限公司
重庆百货	重庆百货大楼股份有限公司
深圳翰宇药业股份有限公司	深圳翰宇药业股份有限公司
翰宇药业	深圳翰宇药业股份有限公司
武汉中元华电科技股份有限公司	武汉中元华电科技股份有限公司
中元华电	武汉中元华电科技股份有限公司
中国四川国际合作股份有限公司	中国四川国际合作股份有限公司
中川国际	中国四川国际合作股份有限公司
海南亚太实业发展股份有限公司	海南亚太实业发展股份有限公司
亚太实业	海南亚太实业发展股份有限公司
山东六和饲料股份有限公司	山东六和饲料股份有限公司
六和集团	山东六和饲料股份有限公司
青海金瑞矿业发展股份有限公司	青海金瑞矿业发展股份有限公司
金瑞矿业.*ST金瑞	青海金瑞矿业发展股份有限公司
ProcterandGamble	ProcterandGamble
宝洁	ProcterandGamble
泸州老窖股份有限公司	泸州老窖股份有限公司
泸州老窖	泸州老窖股份有限公司
深圳市长方半导体照明股份有限公司	深圳市长方半导体照明股份有限公司
长方照明	深圳市长方半导体照明股份有限公司
西班牙毕尔巴鄂比斯开银行	西班牙毕尔巴鄂比斯开银行
西班牙对外银行	西班牙毕尔巴鄂比斯开银行
深圳市兴森快捷电路科技股份有限公司	深圳市兴森快捷电路科技股份有限公司
兴森科技	深圳市兴森快捷电路科技股份有限公司
广州海格通信集团股份有限公司	广州海格通信集团股份有限公司
海格通信	广州海格通信集团股份有限公司
山西太钢不锈钢股份有限公司	山西太钢不锈钢股份有限公司
太钢不锈	山西太钢不锈钢股份有限公司
中国嘉陵工业股份有限公司(集团)	中国嘉陵工业股份有限公司(集团)
中国嘉陵	中国嘉陵工业股份有限公司(集团)
中国冶金科工集团	中国冶金科工集团
中冶集团	中国冶金科工集团
上海隧道工程股份有限公司	上海隧道工程股份有限公司
隧道股份	上海隧道工程股份有限公司
信达证券股份有限公司	信达证券股份有限公司
信达证券	信达证券股份有限公司
深圳市深信泰丰(集团)股份有限公司	深圳市深信泰丰(集团)股份有限公司
深信泰丰	深圳市深信泰丰(集团)股份有限公司
天津力生制药股份有限公司	天津力生制药股份有限公司
力生制药	天津力生制药股份有限公司
苏州科斯伍德油墨股份有限公司	苏州科斯伍德油墨股份有限公司
科斯伍德	苏州科斯伍德油墨股份有限公司
茂盛控股有限公司	茂盛控股有限公司
茂盛控股	茂盛控股有限公司
南天电子信息产业股份有限公司	南天电子信息产业股份有限公司
南天电子	南天电子信息产业股份有限公司
江通动画股份有限公司	江通动画股份有限公司
江通动漫.*江通动画	江通动画股份有限公司
江苏玉龙钢管股份有限公司	江苏玉龙钢管股份有限公司
玉龙股份	江苏玉龙钢管股份有限公司
株式会社　日立制作所	株式会社　日立制作所
日立	株式会社　日立制作所
联发科技股份有限公司	联发科技股份有限公司
联发科技.*联发科	联发科技股份有限公司
北京合众思壮科技股份有限公司	北京合众思壮科技股份有限公司
合众思壮	北京合众思壮科技股份有限公司
多美滋	多美滋
多美滋	多美滋
中航飞机股份有限公司	中航飞机股份有限公司
中航飞机	中航飞机股份有限公司
航天时代电子技术股份有限公司	航天时代电子技术股份有限公司
航天电子	航天时代电子技术股份有限公司
江西洪城水业股份有限公司	江西洪城水业股份有限公司
洪城水业	江西洪城水业股份有限公司
富国基金管理有限公司	富国基金管理有限公司
富国基金	富国基金管理有限公司
深圳市华鹏飞现代物流股份有限公司	深圳市华鹏飞现代物流股份有限公司
华鹏飞	深圳市华鹏飞现代物流股份有限公司
中海油田服务股份有限公司	中海油田服务股份有限公司
中海油服	中海油田服务股份有限公司
LouisVuitton	LouisVuitton
LouisVuitton	LouisVuitton
长城人寿保险股份有限公司	长城人寿保险股份有限公司
长城人寿	长城人寿保险股份有限公司
四川蓝光实业集团有限公司	四川蓝光实业集团有限公司
蓝光实业	四川蓝光实业集团有限公司
厦门银润投资股份有限公司	厦门银润投资股份有限公司
银润投资	厦门银润投资股份有限公司
广东韶钢松山股份有限公司	广东韶钢松山股份有限公司
韶钢松山.*\\*ST韶钢	广东韶钢松山股份有限公司
施乐公司	施乐公司
施乐	施乐公司
石家庄东方热电股份有限公司	石家庄东方热电股份有限公司
东方热电.*\\*ST东热	石家庄东方热电股份有限公司
哈尔滨电气集团佳木斯电机股份有限公司	哈尔滨电气集团佳木斯电机股份有限公司
佳电股份	哈尔滨电气集团佳木斯电机股份有限公司
宜宾五粮液股份有限公司	宜宾五粮液股份有限公司
五粮液	宜宾五粮液股份有限公司
东北网	东北网
东北网	东北网
东北制药集团股份有限公司	东北制药集团股份有限公司
东北制药	东北制药集团股份有限公司
美国家得宝公司	美国家得宝公司
家得宝	美国家得宝公司
大连实德集团	大连实德集团
大连实德集团	大连实德集团
浙江华盛达实业集团股份有限公司	浙江华盛达实业集团股份有限公司
华盛达	浙江华盛达实业集团股份有限公司
吉林省集安益盛药业股份有限公司	吉林省集安益盛药业股份有限公司
益盛药业	吉林省集安益盛药业股份有限公司
基金观察	基金观察
基金观察	基金观察
深圳一致药业股份有限公司	深圳一致药业股份有限公司
一致药业	深圳一致药业股份有限公司
深圳市宇顺电子股份有限公司	深圳市宇顺电子股份有限公司
宇顺电子	深圳市宇顺电子股份有限公司
中国石化山东泰山石油股份有限公司	中国石化山东泰山石油股份有限公司
泰山石油	中国石化山东泰山石油股份有限公司
北京金源鸿大房地产有限公司	北京金源鸿大房地产有限公司
金源鸿大	北京金源鸿大房地产有限公司
江苏辉丰农化股份有限公司	江苏辉丰农化股份有限公司
辉丰股份.*辉丰农化	江苏辉丰农化股份有限公司
浙江吉华集团有限公司	浙江吉华集团有限公司
浙江吉华	浙江吉华集团有限公司
信泰证券公司	信泰证券公司
信泰证券	信泰证券公司
浙江核新同花顺网络信息股份有限	浙江核新同花顺网络信息股份有限
同花顺	浙江核新同花顺网络信息股份有限
甘肃祁连山水泥集团股份有限公司	甘肃祁连山水泥集团股份有限公司
祁连山	甘肃祁连山水泥集团股份有限公司
中电通信科技有限责任公司	中电通信科技有限责任公司
中电通信	中电通信科技有限责任公司
英国森特理克集团	英国森特理克集团
森特理克	英国森特理克集团
泡泡网	泡泡网
泡泡网	泡泡网
上海嘉宝实业(集团)股份有限公司	上海嘉宝实业(集团)股份有限公司
嘉宝集团	上海嘉宝实业(集团)股份有限公司
国泰基金管理有限公司	国泰基金管理有限公司
国泰基金	国泰基金管理有限公司
恒源祥（集团）有限公司	恒源祥（集团）有限公司
恒源祥	恒源祥（集团）有限公司
深圳市卓翼科技股份有限公司	深圳市卓翼科技股份有限公司
卓翼科技	深圳市卓翼科技股份有限公司
兖州煤业股份有限公司	兖州煤业股份有限公司
兖州煤业	兖州煤业股份有限公司
瑞士诺华制药有限公司	瑞士诺华制药有限公司
瑞士诺华制药有限公司	瑞士诺华制药有限公司
乐普北京医疗器械股份有限公司	乐普北京医疗器械股份有限公司
乐普医疗	乐普北京医疗器械股份有限公司
安徽铜峰电子股份有限公司	安徽铜峰电子股份有限公司
铜峰电子	安徽铜峰电子股份有限公司
众业达电气股份有限公司	众业达电气股份有限公司
众业达	众业达电气股份有限公司
长城集团	长城集团
长城集团	长城集团
Germany'sMetroGroupAG	Germany'sMetroGroupAG
麦德龙	Germany'sMetroGroupAG
华农财产保险股份有限公司	华农财产保险股份有限公司
华农财险	华农财产保险股份有限公司
南海发展股份有限公司	南海发展股份有限公司
南海发展	南海发展股份有限公司
浙江东南网架股份有限公司	浙江东南网架股份有限公司
东南网架	浙江东南网架股份有限公司
北京康得新复合材料股份有限公司	北京康得新复合材料股份有限公司
康得新	北京康得新复合材料股份有限公司
兄弟科技股份有限公司	兄弟科技股份有限公司
兄弟科技	兄弟科技股份有限公司
北京世纪瑞尔技术股份有限公司	北京世纪瑞尔技术股份有限公司
世纪瑞尔	北京世纪瑞尔技术股份有限公司
沈阳商业城股份有限公司	沈阳商业城股份有限公司
商业城	沈阳商业城股份有限公司
中国航空油料集团公司	中国航空油料集团公司
中航油	中国航空油料集团公司
弘毅投资	弘毅投资
弘毅投资	弘毅投资
维维集团	维维集团
维维集团	维维集团
四川方向光电股份有限公司	四川方向光电股份有限公司
\\*ST方向	四川方向光电股份有限公司
南京医药股份有限公司	南京医药股份有限公司
南京医药	南京医药股份有限公司
银亿房地产股份有限公司	银亿房地产股份有限公司
银亿股份	银亿房地产股份有限公司
Altadis公司	Altadis公司
阿达迪斯	Altadis公司
宏源证券股份有限公司	宏源证券股份有限公司
宏源证券	宏源证券股份有限公司
福安药业（集团）股份有限公司	福安药业（集团）股份有限公司
福安药业	福安药业（集团）股份有限公司
湖北能源集团股份有限公司	湖北能源集团股份有限公司
湖北能源	湖北能源集团股份有限公司
沪士电子股份有限公司	沪士电子股份有限公司
沪电股份	沪士电子股份有限公司
浙江双环传动机械股份有限公司	浙江双环传动机械股份有限公司
双环传动	浙江双环传动机械股份有限公司
深圳华控赛格股份有限公司	深圳华控赛格股份有限公司
华控赛格	深圳华控赛格股份有限公司
海南双成药业有限公司	海南双成药业有限公司
双成药业	海南双成药业有限公司
广西金嗓子有限责任公司	广西金嗓子有限责任公司
金嗓子	广西金嗓子有限责任公司
时代出版传媒股份有限公司	时代出版传媒股份有限公司
时代出版	时代出版传媒股份有限公司
湖北东方金钰股份有限公司	湖北东方金钰股份有限公司
东方金钰	湖北东方金钰股份有限公司
中国农业银行股份有限公司	中国农业银行股份有限公司
农业银行	中国农业银行股份有限公司
新疆天宏纸业股份有限公司	新疆天宏纸业股份有限公司
\\*ST天宏	新疆天宏纸业股份有限公司
航天科技控股集团股份有限公司	航天科技控股集团股份有限公司
航天科技	航天科技控股集团股份有限公司
陕西金叶科教集团股份有限公司	陕西金叶科教集团股份有限公司
陕西金叶	陕西金叶科教集团股份有限公司
上海航空股份有限公司	上海航空股份有限公司
上海航空	上海航空股份有限公司
湖北美尔雅股份有限公司	湖北美尔雅股份有限公司
美尔雅	湖北美尔雅股份有限公司
通用电气公司	通用电气公司
通用电气	通用电气公司
空中网	空中网
空中网	空中网
风神轮胎股份有限公司	风神轮胎股份有限公司
风神股份	风神轮胎股份有限公司
普洛股份有限公司	普洛股份有限公司
普洛股份	普洛股份有限公司
湖南红宇耐磨新材料股份有限公司	湖南红宇耐磨新材料股份有限公司
红宇新材	湖南红宇耐磨新材料股份有限公司
鞍山重型矿山机器股份有限公司	鞍山重型矿山机器股份有限公司
鞍重股份	鞍山重型矿山机器股份有限公司
上海盛大网络发展有限公司	上海盛大网络发展有限公司
盛大	上海盛大网络发展有限公司
上海实业集团有限公司	上海实业集团有限公司
上实集团	上海实业集团有限公司
河北威远生物化工股份有限公司	河北威远生物化工股份有限公司
威远生化	河北威远生物化工股份有限公司
贝塔斯曼亚洲投资基金	贝塔斯曼亚洲投资基金
贝塔斯曼亚洲投资基金	贝塔斯曼亚洲投资基金
新恒基集团	新恒基集团
新恒基集团	新恒基集团
北京晨报	北京晨报
北京晨报	北京晨报
烟台正海磁性材料股份有限公司	烟台正海磁性材料股份有限公司
正海磁材	烟台正海磁性材料股份有限公司
厦门华侨电子股份有限公司	厦门华侨电子股份有限公司
厦华电子.*\\*ST厦华	厦门华侨电子股份有限公司
浙富控股集团股份有限公司	浙富控股集团股份有限公司
浙富控股	浙富控股集团股份有限公司
常德网	常德网
常德网	常德网
华润电力控股有限公司	华润电力控股有限公司
华润电力	华润电力控股有限公司
天津松江股份有限公司	天津松江股份有限公司
天津松江	天津松江股份有限公司
浙江金磊高温材料股份有限公司	浙江金磊高温材料股份有限公司
金磊股份	浙江金磊高温材料股份有限公司
中国·天信电线集团有限公司	中国·天信电线集团有限公司
天信集团	中国·天信电线集团有限公司
双钱集团股份有限公司	双钱集团股份有限公司
双钱股份	双钱集团股份有限公司
哈尔滨银行	哈尔滨银行
哈尔滨银行	哈尔滨银行
前程无忧	前程无忧
前程无忧	前程无忧
上海自动化仪表股份有限公司	上海自动化仪表股份有限公司
自仪股份.*上海自动化仪表	上海自动化仪表股份有限公司
北台钢铁集团	北台钢铁集团
北台钢铁	北台钢铁集团
广州市东方宾馆股份有限公司	广州市东方宾馆股份有限公司
东方宾馆	广州市东方宾馆股份有限公司
新时代信托投资股份有限公司	新时代信托投资股份有限公司
新时代信托	新时代信托投资股份有限公司
红网	红网
红网	红网
山东鲁抗医药集团有限公司	山东鲁抗医药集团有限公司
鲁抗	山东鲁抗医药集团有限公司
中信金通证券有限责任公司	中信金通证券有限责任公司
中信金通	中信金通证券有限责任公司
东华工程科技股份有限公司	东华工程科技股份有限公司
东华科技	东华工程科技股份有限公司
中国第一铅笔股份有限公司	中国第一铅笔股份有限公司
中国铅笔	中国第一铅笔股份有限公司
金田实业(集团)股份有限公司	金田实业(集团)股份有限公司
金田实业	金田实业(集团)股份有限公司
广东雪莱特光电科技股份有限公司	广东雪莱特光电科技股份有限公司
雪莱特	广东雪莱特光电科技股份有限公司
江苏银行股份有限公司	江苏银行股份有限公司
江苏银行	江苏银行股份有限公司
广东肇庆星湖生物科技股份有限公司	广东肇庆星湖生物科技股份有限公司
星湖科技	广东肇庆星湖生物科技股份有限公司
中国冶金科工股份有限公司	中国冶金科工股份有限公司
中国中冶	中国冶金科工股份有限公司
俄罗斯石油公司	俄罗斯石油公司
俄罗斯石油公司	俄罗斯石油公司
湖北鼎龙化学股份有限公司	湖北鼎龙化学股份有限公司
鼎龙股份	湖北鼎龙化学股份有限公司
福建省永安林业集团股份有限公司	福建省永安林业集团股份有限公司
永安林业	福建省永安林业集团股份有限公司
lutoushe	lutoushe
路透社	lutoushe
河北敬业集团	河北敬业集团
河北敬业	河北敬业集团
东易日盛家居装饰集团股份有限公司	东易日盛家居装饰集团股份有限公司
东易日盛	东易日盛家居装饰集团股份有限公司
中国食品报	中国食品报
中国食品报	中国食品报
慈铭健康体检管理集团股份有限公司	慈铭健康体检管理集团股份有限公司
慈铭体检	慈铭健康体检管理集团股份有限公司
王老吉	王老吉
王老吉	王老吉
四川友利投资控股股份有限公司	四川友利投资控股股份有限公司
友利控股	四川友利投资控股股份有限公司
美国江森自控有限公司	美国江森自控有限公司
江森自控	美国江森自控有限公司
东风电子科技股份有限公司	东风电子科技股份有限公司
东风科技	东风电子科技股份有限公司
南京纺织品进出口股份有限公司	南京纺织品进出口股份有限公司
南纺股份	南京纺织品进出口股份有限公司
澳大利亚电信公司	澳大利亚电信公司
澳大利亚电信	澳大利亚电信公司
银河娱乐集团	银河娱乐集团
银河娱乐	银河娱乐集团
北京超图软件股份有限公司	北京超图软件股份有限公司
超图软件	北京超图软件股份有限公司
石家庄常山纺织股份有限公司	石家庄常山纺织股份有限公司
常山股份	石家庄常山纺织股份有限公司
北京嘉寓门窗幕墙股份有限公司	北京嘉寓门窗幕墙股份有限公司
嘉寓股份	北京嘉寓门窗幕墙股份有限公司
印度塔塔集团	印度塔塔集团
塔塔	印度塔塔集团
河南新野纺织股份有限公司	河南新野纺织股份有限公司
新野纺织	河南新野纺织股份有限公司
广东鸿图科技股份有限公司	广东鸿图科技股份有限公司
广东鸿图	广东鸿图科技股份有限公司
舜元地产发展股份有限公司	舜元地产发展股份有限公司
S\\*ST天发	舜元地产发展股份有限公司
安徽雷鸣科化股份有限公司	安徽雷鸣科化股份有限公司
雷鸣科化	安徽雷鸣科化股份有限公司
泰信基金管理有限公司	泰信基金管理有限公司
泰信基金	泰信基金管理有限公司
茂硕电源科技股份有限公司	茂硕电源科技股份有限公司
茂硕电源	茂硕电源科技股份有限公司
上海大屯能源股份有限公司	上海大屯能源股份有限公司
上海能源	上海大屯能源股份有限公司
广东东阳光铝业股份有限公司	广东东阳光铝业股份有限公司
东阳光铝	广东东阳光铝业股份有限公司
中国青年报	中国青年报
中国青年报	中国青年报
山东新华医疗器械股份有限公司	山东新华医疗器械股份有限公司
新华医疗	山东新华医疗器械股份有限公司
武汉华中数控股份有限公司	武汉华中数控股份有限公司
华中数控	武汉华中数控股份有限公司
西藏旅游股份有限公司	西藏旅游股份有限公司
西藏旅游	西藏旅游股份有限公司
日本烟草公司	日本烟草公司
日本烟草	日本烟草公司
浙江展诚建设集团股份有限公司	浙江展诚建设集团股份有限公司
展诚集团	浙江展诚建设集团股份有限公司
交银施罗德基金管理有限公司	交银施罗德基金管理有限公司
交银施罗德.*交银施罗德基金	交银施罗德基金管理有限公司
湖北兴发化工集团股份有限公司	湖北兴发化工集团股份有限公司
兴发集团	湖北兴发化工集团股份有限公司
江苏康缘药业股份有限公司	江苏康缘药业股份有限公司
康缘药业	江苏康缘药业股份有限公司
德国汉莎集团	德国汉莎集团
汉莎集团	德国汉莎集团
湖北凯乐科技股份有限公司	湖北凯乐科技股份有限公司
凯乐科技	湖北凯乐科技股份有限公司
中国春雨集团有限公司	中国春雨集团有限公司
春雨集团	中国春雨集团有限公司
凡客诚品北京科技有限公司	凡客诚品北京科技有限公司
凡客诚品	凡客诚品北京科技有限公司
上海华虹计通智能系统股份有限公司	上海华虹计通智能系统股份有限公司
华虹计通	上海华虹计通智能系统股份有限公司
雪佛龙-德士古公司	雪佛龙-德士古公司
雪佛龙公司	雪佛龙-德士古公司
民丰特种纸股份有限公司	民丰特种纸股份有限公司
民丰特纸	民丰特种纸股份有限公司
包头铝业股份有限公司	包头铝业股份有限公司
包头铝业	包头铝业股份有限公司
碧桂园控股有限公司	碧桂园控股有限公司
碧桂园	碧桂园控股有限公司
大商股份有限公司	大商股份有限公司
大商股份	大商股份有限公司
长江出版传媒股份有限公司	长江出版传媒股份有限公司
长江传媒	长江出版传媒股份有限公司
江苏宝利沥青	江苏宝利沥青
江苏宝利沥青	江苏宝利沥青
沈阳飞机工业集团有限公司	沈阳飞机工业集团有限公司
中国沈飞工业集团	沈阳飞机工业集团有限公司
杭州新世纪信息技术股份有限公司　	杭州新世纪信息技术股份有限公司　
杭州新世纪	杭州新世纪信息技术股份有限公司　
台湾宏达国际电子股份有限公司	台湾宏达国际电子股份有限公司
宏达电子	台湾宏达国际电子股份有限公司
浙江华欣控股集团	浙江华欣控股集团
浙江华欣控股集团	浙江华欣控股集团
厦门象屿集团有限公司	厦门象屿集团有限公司
象屿集团	厦门象屿集团有限公司
大唐高鸿数据网络技术股份有限公司	大唐高鸿数据网络技术股份有限公司
高鸿股份	大唐高鸿数据网络技术股份有限公司
上海申通地铁股份有限公司	上海申通地铁股份有限公司
申通地铁	上海申通地铁股份有限公司
河北先河环保科技股份有限公司	河北先河环保科技股份有限公司
先河环保	河北先河环保科技股份有限公司
山东五征集团	山东五征集团
五征集团	山东五征集团
北京动力源科技股份有限公司	北京动力源科技股份有限公司
动力源	北京动力源科技股份有限公司
红星美凯龙集团	红星美凯龙集团
红星美凯龙	红星美凯龙集团
江苏吴中实业股份有限公司	江苏吴中实业股份有限公司
江苏吴中	江苏吴中实业股份有限公司
海南双成药业股份有限公司	海南双成药业股份有限公司
双成药业	海南双成药业股份有限公司
重庆建峰化工股份有限公司	重庆建峰化工股份有限公司
建峰化工	重庆建峰化工股份有限公司
秦川机床集团有限公司	秦川机床集团有限公司
秦川集团	秦川机床集团有限公司
河南森源电气股份有限公司	河南森源电气股份有限公司
森源电气	河南森源电气股份有限公司
中铁信托有限责任公司	中铁信托有限责任公司
中铁信托	中铁信托有限责任公司
华润置地北京股份有限公司	华润置地北京股份有限公司
华润置地	华润置地北京股份有限公司
河南纳士科技股份有限公司	河南纳士科技股份有限公司
纳士科技	河南纳士科技股份有限公司
华芳纺织股份有限公司	华芳纺织股份有限公司
华芳纺织	华芳纺织股份有限公司
吉峰农机连锁股份有限公司	吉峰农机连锁股份有限公司
吉峰农机	吉峰农机连锁股份有限公司
浙江卫星石化股份有限公司	浙江卫星石化股份有限公司
卫星石化	浙江卫星石化股份有限公司
浙江海正药业股份有限公司	浙江海正药业股份有限公司
海正药业	浙江海正药业股份有限公司
长园集团股份有限公司	长园集团股份有限公司
长园集团	长园集团股份有限公司
罗氏制药有限公司	罗氏制药有限公司
罗氏制药	罗氏制药有限公司
拉法基集团	拉法基集团
拉法基	拉法基集团
浙江明牌珠宝股份有限公司	浙江明牌珠宝股份有限公司
明牌珠宝	浙江明牌珠宝股份有限公司
隆鑫控股有限公司	隆鑫控股有限公司
隆鑫控股	隆鑫控股有限公司
云南天本智工贸公司	云南天本智工贸公司
天本智	云南天本智工贸公司
福建青松股份有限公司	福建青松股份有限公司
青松股份	福建青松股份有限公司
上海海欣集团股份有限公司	上海海欣集团股份有限公司
海欣股份	上海海欣集团股份有限公司
渤海银行	渤海银行
渤海银行	渤海银行
岳阳兴长石化股份有限公司	岳阳兴长石化股份有限公司
岳阳兴长	岳阳兴长石化股份有限公司
国旅联合股份有限公司	国旅联合股份有限公司
国旅联合	国旅联合股份有限公司
zhengongfu	zhengongfu
真功夫	zhengongfu
中国兵器工业集团公司	中国兵器工业集团公司
中国兵器工业集团公司	中国兵器工业集团公司
股市动态分析	股市动态分析
股市动态分析	股市动态分析
瑞福德健康保险股份有限公司	瑞福德健康保险股份有限公司
瑞福德健康险	瑞福德健康保险股份有限公司
生活日报	生活日报
生活日报	生活日报
江苏九鼎新材料股份有限公司	江苏九鼎新材料股份有限公司
九鼎新材	江苏九鼎新材料股份有限公司
深圳中冠纺织印染股份有限公司	深圳中冠纺织印染股份有限公司
深中冠.*\\*ST中冠A	深圳中冠纺织印染股份有限公司
北京佳讯飞鸿电气股份有限公司	北京佳讯飞鸿电气股份有限公司
佳讯飞鸿	北京佳讯飞鸿电气股份有限公司
神龙汽车有限公司	神龙汽车有限公司
神龙汽车	神龙汽车有限公司
湖南汉森制药股份有限公司	湖南汉森制药股份有限公司
汉森制药	湖南汉森制药股份有限公司
江苏旷达汽车织物集团股份有限公司	江苏旷达汽车织物集团股份有限公司
江苏旷达	江苏旷达汽车织物集团股份有限公司
中国国际海运集装箱集团股份有限公司	中国国际海运集装箱集团股份有限公司
中集集团	中国国际海运集装箱集团股份有限公司
常林股份有限公司	常林股份有限公司
常林股份	常林股份有限公司
江西中江地产股份有限公司	江西中江地产股份有限公司
中江地产	江西中江地产股份有限公司
中国商用飞机有限责任公司	中国商用飞机有限责任公司
中国商飞	中国商用飞机有限责任公司
广州中海达卫星导航技术股份有限公司	广州中海达卫星导航技术股份有限公司
中海达	广州中海达卫星导航技术股份有限公司
默沙东公司	默沙东公司
默克集团	默沙东公司
北京双鹭药业股份有限公司	北京双鹭药业股份有限公司
双鹭药业	北京双鹭药业股份有限公司
北京数码视讯科技股份有限公司	北京数码视讯科技股份有限公司
数码视讯	北京数码视讯科技股份有限公司
重庆华宇物业集团有限公司	重庆华宇物业集团有限公司
华宇集团	重庆华宇物业集团有限公司
内蒙古霍林河露天煤业股份有限公司	内蒙古霍林河露天煤业股份有限公司
露天煤业	内蒙古霍林河露天煤业股份有限公司
广州普邦园林股份有限公司	广州普邦园林股份有限公司
普邦园林	广州普邦园林股份有限公司
天润曲轴股份有限公司	天润曲轴股份有限公司
天润曲轴	天润曲轴股份有限公司
湖北蓝鼎控股股份有限公司	湖北蓝鼎控股股份有限公司
蓝鼎控股	湖北蓝鼎控股股份有限公司
美国房利美公司	美国房利美公司
房利美	美国房利美公司
屈臣氏集团	屈臣氏集团
屈臣氏	屈臣氏集团
日本理光集团	日本理光集团
理光	日本理光集团
浙江华峰氨纶股份有限公司	浙江华峰氨纶股份有限公司
华峰氨纶	浙江华峰氨纶股份有限公司
中铁物流集团有限公司	中铁物流集团有限公司
中铁物流	中铁物流集团有限公司
长信基金管理有限责任公司	长信基金管理有限责任公司
长信基金	长信基金管理有限责任公司
香港怡和集团简介	香港怡和集团简介
怡和洋行	香港怡和集团简介
广西五洲交通股份有限公司	广西五洲交通股份有限公司
五洲交通	广西五洲交通股份有限公司
河南莲花味精股份有限公司	河南莲花味精股份有限公司
莲花味精	河南莲花味精股份有限公司
广西梧州中恒集团股份有限公司	广西梧州中恒集团股份有限公司
中恒集团	广西梧州中恒集团股份有限公司
全景网	全景网
全景网	全景网
中国日报	中国日报
中国日报	中国日报
山东江泉实业股份有限公司	山东江泉实业股份有限公司
江泉实业	山东江泉实业股份有限公司
北海国发海洋生物产业股份有限公司	北海国发海洋生物产业股份有限公司
北海国发	北海国发海洋生物产业股份有限公司
兰州佛慈制药股份有限公司	兰州佛慈制药股份有限公司
佛慈制药	兰州佛慈制药股份有限公司
江苏舜天船舶股份有限公司	江苏舜天船舶股份有限公司
舜天船舶	江苏舜天船舶股份有限公司
江苏金辉集团公司	江苏金辉集团公司
金辉集团	江苏金辉集团公司
浙江杭萧钢构股份有限公司	浙江杭萧钢构股份有限公司
杭萧钢构	浙江杭萧钢构股份有限公司
江苏鹿港科技股份有限公司	江苏鹿港科技股份有限公司
鹿港科技	江苏鹿港科技股份有限公司
四川广安爱众股份有限公司	四川广安爱众股份有限公司
广安爱众	四川广安爱众股份有限公司
武汉三镇实业控股股份有限公司	武汉三镇实业控股股份有限公司
武汉控股	武汉三镇实业控股股份有限公司
北海银河高科技产业股份有限公司	北海银河高科技产业股份有限公司
银河科技	北海银河高科技产业股份有限公司
济南锅炉集团有限公司	济南锅炉集团有限公司
济南锅炉	济南锅炉集团有限公司
中国广播网	中国广播网
中国广播网	中国广播网
横店集团东磁股份有限公司	横店集团东磁股份有限公司
横店东磁	横店集团东磁股份有限公司
唐山汇中仪表股份有限公司	唐山汇中仪表股份有限公司
汇中股份	唐山汇中仪表股份有限公司
华瑞制药有限公司	华瑞制药有限公司
华瑞制药	华瑞制药有限公司
成都市新都化工股份有限公司	成都市新都化工股份有限公司
新都化工	成都市新都化工股份有限公司
浙江尤夫高新纤维股份有限公司	浙江尤夫高新纤维股份有限公司
尤夫股份	浙江尤夫高新纤维股份有限公司
美国百时美施贵宝公司	美国百时美施贵宝公司
百时美施贵宝	美国百时美施贵宝公司
黑牛食品股份有限公司	黑牛食品股份有限公司
黑牛食品	黑牛食品股份有限公司
阳光100置业集团	阳光100置业集团
阳光100	阳光100置业集团
西安开元控股集团股份有限公司	西安开元控股集团股份有限公司
开元控股	西安开元控股集团股份有限公司
深圳市金证科技股份有限公司	深圳市金证科技股份有限公司
金证股份	深圳市金证科技股份有限公司
深圳市同洲电子股份有限公司	深圳市同洲电子股份有限公司
同洲电子	深圳市同洲电子股份有限公司
上海氯碱化工股份有限公司	上海氯碱化工股份有限公司
氯碱化工	上海氯碱化工股份有限公司
深圳市方直科技股份有限公司	深圳市方直科技股份有限公司
方直科技	深圳市方直科技股份有限公司
精工爱普生公司	精工爱普生公司
爱普生	精工爱普生公司
冠城大通股份有限公司	冠城大通股份有限公司
冠城大通	冠城大通股份有限公司
湖南梦洁家纺股份有限公司	湖南梦洁家纺股份有限公司
梦洁家纺	湖南梦洁家纺股份有限公司
重庆商社（集团）有限公司	重庆商社（集团）有限公司
重庆商社	重庆商社（集团）有限公司
浙江龙生汽车部件股份有限公司	浙江龙生汽车部件股份有限公司
龙生股份	浙江龙生汽车部件股份有限公司
河北宝硕股份有限公司	河北宝硕股份有限公司
宝硕股份	河北宝硕股份有限公司
天津滨海能源发展股份有限公司	天津滨海能源发展股份有限公司
滨海能源	天津滨海能源发展股份有限公司
中国石化中原油气高新股份有限公司	中国石化中原油气高新股份有限公司
中原油气	中国石化中原油气高新股份有限公司
延边石岘白麓纸业股份有限公司	延边石岘白麓纸业股份有限公司
石岘纸业.*ST石岘	延边石岘白麓纸业股份有限公司
黑龙江龙涤股份有限公司	黑龙江龙涤股份有限公司
龙涤股份	黑龙江龙涤股份有限公司
大连北大科技(集团)股份有限公司	大连北大科技(集团)股份有限公司
北大科技	大连北大科技(集团)股份有限公司
中国汽车报社	中国汽车报社
中国汽车报社	中国汽车报社
渤海财产保险股份有限公司	渤海财产保险股份有限公司
渤海财险	渤海财产保险股份有限公司
海宁中国皮革城股份有限公司	海宁中国皮革城股份有限公司
海宁皮城	海宁中国皮革城股份有限公司
今晚报	今晚报
今晚报	今晚报
浙江三花股份有限公司	浙江三花股份有限公司
三花股份	浙江三花股份有限公司
上海广电电子股份有限公司	上海广电电子股份有限公司
广电电子	上海广电电子股份有限公司
唐山港集团股份有限公司	唐山港集团股份有限公司
唐山港	唐山港集团股份有限公司
广东江粉磁材股份有限公司	广东江粉磁材股份有限公司
江粉磁材	广东江粉磁材股份有限公司
吴太医药集团	吴太医药集团
吴太集团	吴太医药集团
广东广弘控股股份有限公司	广东广弘控股股份有限公司
广弘控股	广东广弘控股股份有限公司
海润光伏科技股份有限公司	海润光伏科技股份有限公司
海润光伏	海润光伏科技股份有限公司
江苏凤凰置业投资股份有限公司	江苏凤凰置业投资股份有限公司
凤凰股份	江苏凤凰置业投资股份有限公司
中路股份有限公司	中路股份有限公司
中路股份	中路股份有限公司
南通富士通微电子股份有限公司	南通富士通微电子股份有限公司
通富微电	南通富士通微电子股份有限公司
北京光环新网科技股份有限公司	北京光环新网科技股份有限公司
光环新网	北京光环新网科技股份有限公司
大秦铁路股份有限公司	大秦铁路股份有限公司
大秦铁路	大秦铁路股份有限公司
力合股份有限公司	力合股份有限公司
力合股份	力合股份有限公司
安泰科技股份有限公司	安泰科技股份有限公司
安泰科技	安泰科技股份有限公司
江河创建集团股份有限公司	江河创建集团股份有限公司
江河创建	江河创建集团股份有限公司
瑞士联合银行集团	瑞士联合银行集团
瑞银集团	瑞士联合银行集团
奥瑞金包装股份有限公司	奥瑞金包装股份有限公司
奥瑞金	奥瑞金包装股份有限公司
德华兔宝宝装饰新材股份有限公司	德华兔宝宝装饰新材股份有限公司
兔宝宝	德华兔宝宝装饰新材股份有限公司
福建圣农发展股份有限公司	福建圣农发展股份有限公司
圣农发展	福建圣农发展股份有限公司
金地集团股份有限公司	金地集团股份有限公司
金地集团	金地集团股份有限公司
中国航天科技集团公司	中国航天科技集团公司
航天科技集团	中国航天科技集团公司
中国南车股份有限公司	中国南车股份有限公司
中国南车	中国南车股份有限公司
四川依米康环境科技股份有限公司	四川依米康环境科技股份有限公司
依米康	四川依米康环境科技股份有限公司
上海大名城企业股份有限公司	上海大名城企业股份有限公司
大名城	上海大名城企业股份有限公司
武汉钢铁股份有限公司	武汉钢铁股份有限公司
武钢股份	武汉钢铁股份有限公司
上海华联商厦股份有限公司	上海华联商厦股份有限公司
华联商厦	上海华联商厦股份有限公司
四川明星电缆股份有限公司	四川明星电缆股份有限公司
明星电缆	四川明星电缆股份有限公司
伯克希尔·哈撒韦公司	伯克希尔·哈撒韦公司
伯克希尔·哈撒韦公司	伯克希尔·哈撒韦公司
山东钢铁集团有限公司	山东钢铁集团有限公司
山东钢铁	山东钢铁集团有限公司
锦州石化股份有限公司	锦州石化股份有限公司
锦州石化	锦州石化股份有限公司
安徽全柴动力股份有限公司	安徽全柴动力股份有限公司
全柴动力	安徽全柴动力股份有限公司
诺亚舟教育控股有限公司	诺亚舟教育控股有限公司
诺亚舟	诺亚舟教育控股有限公司
杭州杭氧股份有限公司	杭州杭氧股份有限公司
杭氧股份	杭州杭氧股份有限公司
韩国电信公司	韩国电信公司
韩国电信	韩国电信公司
中山日报报业集团	中山日报报业集团
中山日报报业集团	中山日报报业集团
中山达华智能科技股份有限公司	中山达华智能科技股份有限公司
达华智能	中山达华智能科技股份有限公司
海南高速公路股份有限公司	海南高速公路股份有限公司
海南高速	海南高速公路股份有限公司
中铁建工集团有限公司	中铁建工集团有限公司
中铁建工	中铁建工集团有限公司
招商基金管理有限公司	招商基金管理有限公司
招商基金	招商基金管理有限公司
重庆宗申动力机械股份有限公司	重庆宗申动力机械股份有限公司
宗申动力	重庆宗申动力机械股份有限公司
威海广泰空港设备股份有限公司	威海广泰空港设备股份有限公司
威海广泰	威海广泰空港设备股份有限公司
俄罗斯天然气工业股份公司	俄罗斯天然气工业股份公司
俄罗斯天然气工业股份公司	俄罗斯天然气工业股份公司
上海浦东路桥建设股份有限公司	上海浦东路桥建设股份有限公司
浦东建设	上海浦东路桥建设股份有限公司
江南嘉捷电梯股份有限公司	江南嘉捷电梯股份有限公司
江南嘉捷	江南嘉捷电梯股份有限公司
广州智光电气股份有限公司	广州智光电气股份有限公司
智光电气	广州智光电气股份有限公司
浙江闰土股份有限公司	浙江闰土股份有限公司
闰土股份	浙江闰土股份有限公司
珠海欧比特控制工程股份有限公司	珠海欧比特控制工程股份有限公司
欧比特	珠海欧比特控制工程股份有限公司
青岛双星股份有限公司	青岛双星股份有限公司
青岛双星	青岛双星股份有限公司
厦门合兴包装印刷股份有限公司	厦门合兴包装印刷股份有限公司
合兴包装	厦门合兴包装印刷股份有限公司
西班牙伊维尔德罗拉公司	西班牙伊维尔德罗拉公司
伊维尔德罗拉	西班牙伊维尔德罗拉公司
湖北中航精机科技股份有限公司	湖北中航精机科技股份有限公司
中航精机	湖北中航精机科技股份有限公司
中讯传媒集团	中讯传媒集团
中讯传媒	中讯传媒集团
浙江凯恩特种材料股份有限公司	浙江凯恩特种材料股份有限公司
凯恩股份	浙江凯恩特种材料股份有限公司
广发基金管理有限公司	广发基金管理有限公司
广发基金	广发基金管理有限公司
新疆赛里木现代农业股份有限公司	新疆赛里木现代农业股份有限公司
新赛股份	新疆赛里木现代农业股份有限公司
厦门市建筑科学研究院集团股份有限公司	厦门市建筑科学研究院集团股份有限公司
建研集团	厦门市建筑科学研究院集团股份有限公司
迈瑞公司	迈瑞公司
迈瑞医药	迈瑞公司
西藏海思科药业集团股份有限公司	西藏海思科药业集团股份有限公司
海思科	西藏海思科药业集团股份有限公司
深圳市振业(集团)股份有限公司	深圳市振业(集团)股份有限公司
深振业.*深振业Ａ	深圳市振业(集团)股份有限公司
重庆渝开发股份有限公司	重庆渝开发股份有限公司
渝开发	重庆渝开发股份有限公司
哈工大首创科技股份有限公司	哈工大首创科技股份有限公司
工大首创	哈工大首创科技股份有限公司
北京市西单商场股份有限公司	北京市西单商场股份有限公司
西单商场	北京市西单商场股份有限公司
卓越理财	卓越理财
卓越理财	卓越理财
世纪光华科技股份有限公司	世纪光华科技股份有限公司
世纪光华	世纪光华科技股份有限公司
杭州钢铁股份有限公司	杭州钢铁股份有限公司
杭钢股份	杭州钢铁股份有限公司
内蒙古包钢稀土(集团)高科技股份有限公司	内蒙古包钢稀土(集团)高科技股份有限公司
包钢稀土	内蒙古包钢稀土(集团)高科技股份有限公司
黄河实业	黄河实业
黄河实业	黄河实业
张家界旅游集团股份有限公司	张家界旅游集团股份有限公司
张家界	张家界旅游集团股份有限公司
安徽安纳达钛业股份有限公司	安徽安纳达钛业股份有限公司
安纳达	安徽安纳达钛业股份有限公司
天虹商场股份有限公司	天虹商场股份有限公司
天虹商场	天虹商场股份有限公司
航美传媒	航美传媒
航美传媒	航美传媒
海虹企业(控股)股份有限公司	海虹企业(控股)股份有限公司
海虹控股	海虹企业(控股)股份有限公司
广东顺威精密塑料股份有限公司	广东顺威精密塑料股份有限公司
顺威股份	广东顺威精密塑料股份有限公司
深圳市理邦精密仪器股份有限公司	深圳市理邦精密仪器股份有限公司
理邦仪器	深圳市理邦精密仪器股份有限公司
广东伊立浦电器股份有限公司	广东伊立浦电器股份有限公司
伊立浦	广东伊立浦电器股份有限公司
广东宜通世纪科技股份有限公司	广东宜通世纪科技股份有限公司
宜通世纪	广东宜通世纪科技股份有限公司
人民日报	人民日报
人民日报	人民日报
太极计算机股份有限公司	太极计算机股份有限公司
太极股份	太极计算机股份有限公司
深圳市达晨创业投资有限公司	深圳市达晨创业投资有限公司
达晨创投	深圳市达晨创业投资有限公司
深圳市康达尔集团股份有限公司	深圳市康达尔集团股份有限公司
ST康达尔	深圳市康达尔集团股份有限公司
上海贝尔阿尔卡特股份有限公司	上海贝尔阿尔卡特股份有限公司
上海贝尔	上海贝尔阿尔卡特股份有限公司
安徽中鼎密封件股份有限公司	安徽中鼎密封件股份有限公司
中鼎股份	安徽中鼎密封件股份有限公司
美国美亚保险公司	美国美亚保险公司
美亚保险	美国美亚保险公司
上海宝华企业集团有限公司	上海宝华企业集团有限公司
上海宝华	上海宝华企业集团有限公司
立讯精密工业股份有限公司	立讯精密工业股份有限公司
立讯精密	立讯精密工业股份有限公司
浙江栋梁新材股份有限公司	浙江栋梁新材股份有限公司
栋梁新材	浙江栋梁新材股份有限公司
中国铁通集团有限公司	中国铁通集团有限公司
中国铁通	中国铁通集团有限公司
方大特钢科技股份有限公司	方大特钢科技股份有限公司
方大特钢	方大特钢科技股份有限公司
北亚实业集团股份有限公司	北亚实业集团股份有限公司
S\\*ST北亚	北亚实业集团股份有限公司
浙江亿利达风机股份有限公司	浙江亿利达风机股份有限公司
亿利达	浙江亿利达风机股份有限公司
北京首创股份有限公司	北京首创股份有限公司
首创股份	北京首创股份有限公司
浙江跃岭股份有限公司	浙江跃岭股份有限公司
跃岭股份	浙江跃岭股份有限公司
中国交通建设股份有限公司	中国交通建设股份有限公司
中国交建.*中交集团	中国交通建设股份有限公司
山东小鸭集团	山东小鸭集团
小鸭集团	山东小鸭集团
新鸿基地产发展有限公司	新鸿基地产发展有限公司
新鸿基地产	新鸿基地产发展有限公司
安徽荃银高科种业股份有限公司	安徽荃银高科种业股份有限公司
荃银高科	安徽荃银高科种业股份有限公司
中国再保险集团股份有限公司	中国再保险集团股份有限公司
中国再保险集团公司	中国再保险集团股份有限公司
日照钢铁控股集团有限公司	日照钢铁控股集团有限公司
日照钢铁	日照钢铁控股集团有限公司
上海棱光实业股份有限公司	上海棱光实业股份有限公司
棱光实业	上海棱光实业股份有限公司
杭州解百集团股份有限公司	杭州解百集团股份有限公司
杭州解百	杭州解百集团股份有限公司
丹化化工科技股份有限公司	丹化化工科技股份有限公司
丹化科技	丹化化工科技股份有限公司
北京中关村科技发展(控股)股份有限公司	北京中关村科技发展(控股)股份有限公司
中关村	北京中关村科技发展(控股)股份有限公司
大湖水殖股份有限公司	大湖水殖股份有限公司
大湖股份	大湖水殖股份有限公司
中铁二局股份有限公司	中铁二局股份有限公司
中铁二局	中铁二局股份有限公司
广东雅士利集团股份有限公司	广东雅士利集团股份有限公司
雅士利	广东雅士利集团股份有限公司
山东鲁抗辰欣药业有限公司	山东鲁抗辰欣药业有限公司
鲁抗辰欣	山东鲁抗辰欣药业有限公司
宝盈基金管理有限公司	宝盈基金管理有限公司
宝盈基金	宝盈基金管理有限公司
青岛碱业股份有限公司	青岛碱业股份有限公司
青岛碱业	青岛碱业股份有限公司
陕西西凤酒集团股份有限公司　	陕西西凤酒集团股份有限公司　
西凤酒	陕西西凤酒集团股份有限公司　
辽宁沈宏集团股份有限公司	辽宁沈宏集团股份有限公司
沈宏集团	辽宁沈宏集团股份有限公司
掌上灵通咨询有限公司	掌上灵通咨询有限公司
掌上灵通	掌上灵通咨询有限公司
内蒙古四海科技股份有限公司	内蒙古四海科技股份有限公司
四海股份	内蒙古四海科技股份有限公司
英国联合博姿公司	英国联合博姿公司
联合博姿	英国联合博姿公司
深圳市佳士科技股份有限公司	深圳市佳士科技股份有限公司
佳士科技	深圳市佳士科技股份有限公司
浙江友邦集成吊顶股份有限公司	浙江友邦集成吊顶股份有限公司
友邦吊顶	浙江友邦集成吊顶股份有限公司
运盛(上海)实业股份有限公司	运盛(上海)实业股份有限公司
运盛实业	运盛(上海)实业股份有限公司
福建三元达通讯股份有限公司	福建三元达通讯股份有限公司
三元达	福建三元达通讯股份有限公司
中法人寿保险有限责任公司	中法人寿保险有限责任公司
中法人寿	中法人寿保险有限责任公司
上海海博股份有限公司	上海海博股份有限公司
海博股份	上海海博股份有限公司
重庆华立药业股份有限公司	重庆华立药业股份有限公司
华立药业	重庆华立药业股份有限公司
江苏光芒集团	江苏光芒集团
光芒集团	江苏光芒集团
新华联不动产股份有限公司	新华联不动产股份有限公司
新华联	新华联不动产股份有限公司
青岛特锐德电气股份有限公司	青岛特锐德电气股份有限公司
特锐德.*特锐德电气	青岛特锐德电气股份有限公司
厦门金达威集团股份有限公司	厦门金达威集团股份有限公司
金达威	厦门金达威集团股份有限公司
中意人寿保险有限公司	中意人寿保险有限公司
中意人寿	中意人寿保险有限公司
潍坊亚星化学股份有限公司	潍坊亚星化学股份有限公司
亚星化学	潍坊亚星化学股份有限公司
远东电缆股份有限公司	远东电缆股份有限公司
远东电缆	远东电缆股份有限公司
上海一开电气集团	上海一开电气集团
一开集团	上海一开电气集团
康师傅控股有限公司	康师傅控股有限公司
康师傅	康师傅控股有限公司
湖南大康牧业股份有限公司	湖南大康牧业股份有限公司
大康牧业	湖南大康牧业股份有限公司
北京新华联恒业房地产开发有限公司	北京新华联恒业房地产开发有限公司
新华联集团	北京新华联恒业房地产开发有限公司
西安通源石油科技股份有限公司	西安通源石油科技股份有限公司
通源石油	西安通源石油科技股份有限公司
中国铝业股份有限公司	中国铝业股份有限公司
中国铝业	中国铝业股份有限公司
亚洲卫星控股有限公司	亚洲卫星控股有限公司
亚洲卫星	亚洲卫星控股有限公司
长城信息产业股份有限公司	长城信息产业股份有限公司
长城信息	长城信息产业股份有限公司
皇明太阳能集团	皇明太阳能集团
皇明太阳能	皇明太阳能集团
味千中国控股有限公司	味千中国控股有限公司
味千中国	味千中国控股有限公司
上海金力泰化工股份有限公司	上海金力泰化工股份有限公司
金力泰	上海金力泰化工股份有限公司
华夏人寿保险股份有限公司	华夏人寿保险股份有限公司
华夏人寿	华夏人寿保险股份有限公司
深圳市科陆电子科技股份有限公司	深圳市科陆电子科技股份有限公司
科陆电子	深圳市科陆电子科技股份有限公司
太原煤气化股份有限公司	太原煤气化股份有限公司
煤气化	太原煤气化股份有限公司
苏州东瑞制药有限公司	苏州东瑞制药有限公司
东瑞制药	苏州东瑞制药有限公司
嘉实基金管理有限公司	嘉实基金管理有限公司
嘉实基金	嘉实基金管理有限公司
北京安控科技股份有限公司	北京安控科技股份有限公司
安控股份	北京安控科技股份有限公司
长春建工集团有限公司	长春建工集团有限公司
长春建工	长春建工集团有限公司
东方通信股份有限公司	东方通信股份有限公司
东方通信	东方通信股份有限公司
21shijijingjibaodao	21shijijingjibaodao
21世纪经济报道	21shijijingjibaodao
北京探路者户外用品股份有限公司	北京探路者户外用品股份有限公司
探路者	北京探路者户外用品股份有限公司
法国巴黎银行	法国巴黎银行
巴黎银行	法国巴黎银行
山东蓝帆塑胶股份有限公司	山东蓝帆塑胶股份有限公司
蓝帆股份	山东蓝帆塑胶股份有限公司
经济观察网	经济观察网
经济观察网	经济观察网
滨化集团股份有限公司	滨化集团股份有限公司
滨化股份	滨化集团股份有限公司
深圳大洋海运股份有限公司	深圳大洋海运股份有限公司
深大洋	深圳大洋海运股份有限公司
江苏亚威机床股份有限公司	江苏亚威机床股份有限公司
亚威股份	江苏亚威机床股份有限公司
辽宁时代服装进出口股份有限公司	辽宁时代服装进出口股份有限公司
辽宁时代	辽宁时代服装进出口股份有限公司
江苏鱼跃医疗设备股份有限公司	江苏鱼跃医疗设备股份有限公司
鱼跃医疗	江苏鱼跃医疗设备股份有限公司
信泰人寿保险股份有限公司	信泰人寿保险股份有限公司
信泰人寿	信泰人寿保险股份有限公司
中国邮政集团公司	中国邮政集团公司
中国邮政	中国邮政集团公司
苏州固锝电子股份有限公司	苏州固锝电子股份有限公司
苏州固锝	苏州固锝电子股份有限公司
中国第一拖拉机工程机械集团	中国第一拖拉机工程机械集团
中国一拖	中国第一拖拉机工程机械集团
安徽安利合成革股份有限公司	安徽安利合成革股份有限公司
安利股份	安徽安利合成革股份有限公司
长江润发机械股份有限公司	长江润发机械股份有限公司
长江润发	长江润发机械股份有限公司
山东晨鸣纸业集团股份有限公司	山东晨鸣纸业集团股份有限公司
晨鸣纸业	山东晨鸣纸业集团股份有限公司
山东联创节能新材料股份有限公司	山东联创节能新材料股份有限公司
联创节能	山东联创节能新材料股份有限公司
国投中鲁果汁股份有限公司	国投中鲁果汁股份有限公司
国投中鲁	国投中鲁果汁股份有限公司
安诚财产保险股份有限公司	安诚财产保险股份有限公司
安诚财险	安诚财产保险股份有限公司
绿景控股股份有限公司	绿景控股股份有限公司
绿景控股	绿景控股股份有限公司
厦门蒙发利科技(集团)股份有限公司	厦门蒙发利科技(集团)股份有限公司
蒙发利	厦门蒙发利科技(集团)股份有限公司
上海市华联典当行有限公司	上海市华联典当行有限公司
华联典当	上海市华联典当行有限公司
家润多商业股份有限公司	家润多商业股份有限公司
家润多	家润多商业股份有限公司
中核华原钛白股份有限公司	中核华原钛白股份有限公司
中核钛白	中核华原钛白股份有限公司
扬州亚星客车股份有限公司	扬州亚星客车股份有限公司
亚星客车	扬州亚星客车股份有限公司
广东明珠集团股份有限公司	广东明珠集团股份有限公司
广东明珠	广东明珠集团股份有限公司
江苏吴江中国东方丝绸市场股份有限公司	江苏吴江中国东方丝绸市场股份有限公司
东方市场	江苏吴江中国东方丝绸市场股份有限公司
深圳拓邦股份有限公司	深圳拓邦股份有限公司
拓邦股份	深圳拓邦股份有限公司
中纺投资发展股份有限公司	中纺投资发展股份有限公司
中纺投资	中纺投资发展股份有限公司
李宁体育用品有限公司	李宁体育用品有限公司
李宁体育用品有限公司	李宁体育用品有限公司
上海龙宇燃油股份有限公司	上海龙宇燃油股份有限公司
龙宇燃油	上海龙宇燃油股份有限公司
湘火炬汽车集团股份有限公司	湘火炬汽车集团股份有限公司
湘火炬.*S湘火炬	湘火炬汽车集团股份有限公司
黄山金马股份有限公司	黄山金马股份有限公司
金马股份	黄山金马股份有限公司
招商银行股份有限公司	招商银行股份有限公司
招商银行	招商银行股份有限公司
神州学人集团股份有限公司	神州学人集团股份有限公司
神州学人.*闽福发A.*闽福发Ａ	神州学人集团股份有限公司
浦银安盛基金管理有限公司	浦银安盛基金管理有限公司
浦银安盛.*浦银安盛基金	浦银安盛基金管理有限公司
深圳市海王生物工程股份有限公司	深圳市海王生物工程股份有限公司
海王生物	深圳市海王生物工程股份有限公司
中国邮政储蓄银行有限责任公司	中国邮政储蓄银行有限责任公司
邮储银行	中国邮政储蓄银行有限责任公司
珠海万力达电气股份有限公司	珠海万力达电气股份有限公司
万力达	珠海万力达电气股份有限公司
深圳市桑达实业股份有限公司	深圳市桑达实业股份有限公司
深桑达.*深桑达A.*深桑达Ａ	深圳市桑达实业股份有限公司
天津创业环保集团股份有限公司	天津创业环保集团股份有限公司
创业环保	天津创业环保集团股份有限公司
四川海特高新技术股份有限公司	四川海特高新技术股份有限公司
海特高新	四川海特高新技术股份有限公司
山东道恩集团简介	山东道恩集团简介
道恩集团	山东道恩集团简介
株洲天桥起重机股份有限公司	株洲天桥起重机股份有限公司
天桥起重	株洲天桥起重机股份有限公司
深圳顺络电子股份有限公司	深圳顺络电子股份有限公司
顺络电子	深圳顺络电子股份有限公司
浙江大立科技股份有限公司	浙江大立科技股份有限公司
大立科技	浙江大立科技股份有限公司
深圳市宝鹰建设控股集团股份有限公司	深圳市宝鹰建设控股集团股份有限公司
宝鹰股份	深圳市宝鹰建设控股集团股份有限公司
中国石化齐鲁股份有限公司	中国石化齐鲁股份有限公司
齐鲁石化	中国石化齐鲁股份有限公司
河北金牛能源股份有限公司	河北金牛能源股份有限公司
金牛能源	河北金牛能源股份有限公司
中国银河证券股份有限公司	中国银河证券股份有限公司
银河证券	中国银河证券股份有限公司
浙江巨龙管业股份有限公司	浙江巨龙管业股份有限公司
巨龙管业	浙江巨龙管业股份有限公司
江苏通达动力科技股份有限公司	江苏通达动力科技股份有限公司
通达动力	江苏通达动力科技股份有限公司
酷6网	酷6网
酷6网	酷6网
安科瑞电气股份有限公司	安科瑞电气股份有限公司
安科瑞	安科瑞电气股份有限公司
中材科技股份有限公司	中材科技股份有限公司
中材科技	中材科技股份有限公司
厦门科华恒盛股份有限公司	厦门科华恒盛股份有限公司
科华恒盛	厦门科华恒盛股份有限公司
广东鸿特精密技术股份有限公司	广东鸿特精密技术股份有限公司
鸿特精密	广东鸿特精密技术股份有限公司
成都市新筑路桥机械股份有限公司	成都市新筑路桥机械股份有限公司
新筑股份	成都市新筑路桥机械股份有限公司
比特科技控股股份有限公司	比特科技控股股份有限公司
比特科技	比特科技控股股份有限公司
江苏永钢集团有限公司	江苏永钢集团有限公司
永钢	江苏永钢集团有限公司
济南鑫玉塑业有限公司	济南鑫玉塑业有限公司
济南鑫玉	济南鑫玉塑业有限公司
大全集团	大全集团
大全集团	大全集团
东旭光电科技股份有限公司	东旭光电科技股份有限公司
东旭光电	东旭光电科技股份有限公司
恒信移动商务股份有限公司	恒信移动商务股份有限公司
恒信移动	恒信移动商务股份有限公司
江苏四环生物股份有限公司	江苏四环生物股份有限公司
四环生物	江苏四环生物股份有限公司
厦门安妮股份有限公司	厦门安妮股份有限公司
安妮股份	厦门安妮股份有限公司
西安商业银行股份有限公司	西安商业银行股份有限公司
西安市商业银行	西安商业银行股份有限公司
广深铁路股份有限公司	广深铁路股份有限公司
广深铁路	广深铁路股份有限公司
上海证券有限责任公司	上海证券有限责任公司
上海证券	上海证券有限责任公司
扬子江船业控股有限公司	扬子江船业控股有限公司
扬子江船业	扬子江船业控股有限公司
湖北中烟工业有限责任公司	湖北中烟工业有限责任公司
湖北中烟工业公司	湖北中烟工业有限责任公司
太原天龙集团股份有限公司	太原天龙集团股份有限公司
天龙集团	太原天龙集团股份有限公司
江苏亨通光电股份有限公司	江苏亨通光电股份有限公司
亨通光电	江苏亨通光电股份有限公司
上海医药集团股份有限公司	上海医药集团股份有限公司
上海医药	上海医药集团股份有限公司
中国石油天然气股份有限公司	中国石油天然气股份有限公司
中国石油	中国石油天然气股份有限公司
印度石油天然气公司	印度石油天然气公司
印度石油天然气公司	印度石油天然气公司
中储发展股份有限公司	中储发展股份有限公司
中储股份	中储发展股份有限公司
英国特易购公司简介	英国特易购公司简介
特易购	英国特易购公司简介
渤海租赁股份有限公司	渤海租赁股份有限公司
渤海租赁	渤海租赁股份有限公司
株洲千金药业股份有限公司	株洲千金药业股份有限公司
千金药业	株洲千金药业股份有限公司
西林钢铁	西林钢铁
西林钢铁	西林钢铁
北京石油化工设计院	北京石油化工设计院
北京石油化工设计院	北京石油化工设计院
复地集团股份有限公司	复地集团股份有限公司
复地集团	复地集团股份有限公司
深圳中恒华发股份有限公司	深圳中恒华发股份有限公司
深华发.*深华发Ａ	深圳中恒华发股份有限公司
四川九洲电器股份有限公司	四川九洲电器股份有限公司
四川九洲	四川九洲电器股份有限公司
烟台双塔食品股份有限公司	烟台双塔食品股份有限公司
双塔食品	烟台双塔食品股份有限公司
兴业全球基金管理有限公司	兴业全球基金管理有限公司
兴业全球.*兴业全球基金	兴业全球基金管理有限公司
安徽古井贡酒股份有限公司	安徽古井贡酒股份有限公司
古井贡酒	安徽古井贡酒股份有限公司
北京海兰信数据科技股份有限公司	北京海兰信数据科技股份有限公司
海兰信	北京海兰信数据科技股份有限公司
中原特钢股份有限公司	中原特钢股份有限公司
中原特钢	中原特钢股份有限公司
深圳市洪涛装饰股份有限公司	深圳市洪涛装饰股份有限公司
洪涛股份	深圳市洪涛装饰股份有限公司
重庆博赛矿业（集团）股份有限公司	重庆博赛矿业（集团）股份有限公司
博赛矿业	重庆博赛矿业（集团）股份有限公司
陕西煤业股份有限公司	陕西煤业股份有限公司
陕西煤业	陕西煤业股份有限公司
通威股份有限公司	通威股份有限公司
通威股份	通威股份有限公司
法国安盟-甘集团	法国安盟-甘集团
安盟-甘	法国安盟-甘集团
江苏新民纺织科技股份有限公司	江苏新民纺织科技股份有限公司
新民科技	江苏新民纺织科技股份有限公司
乐金	乐金
LG集团	乐金
鞍山合成(集团)股份有限公司	鞍山合成(集团)股份有限公司
鞍山合成	鞍山合成(集团)股份有限公司
万达信息股份有限公司	万达信息股份有限公司
万达信息	万达信息股份有限公司
龙星化工股份有限公司	龙星化工股份有限公司
龙星化工	龙星化工股份有限公司
乌鲁木齐市商业银行	乌鲁木齐市商业银行
乌鲁木齐市商业银行	乌鲁木齐市商业银行
瓦莱罗能源公司	瓦莱罗能源公司
瓦莱罗	瓦莱罗能源公司
浙江吉利控股集团有限公司	浙江吉利控股集团有限公司
吉利汽车	浙江吉利控股集团有限公司
华润雪花啤酒（中国）有限公司	华润雪花啤酒（中国）有限公司
华润雪花啤酒	华润雪花啤酒（中国）有限公司
四川省川威集团有限公司	四川省川威集团有限公司
川威集团	四川省川威集团有限公司
中华联合财产保险公司	中华联合财产保险公司
中华保险	中华联合财产保险公司
南通江山农药化工股份有限公司	南通江山农药化工股份有限公司
江山股份	南通江山农药化工股份有限公司
大众保险股份有限公司	大众保险股份有限公司
大众保险	大众保险股份有限公司
福建省永安林业(集团)股份有限公司	福建省永安林业(集团)股份有限公司
永安林业	福建省永安林业(集团)股份有限公司
深圳市华测检测技术股份有限公司	深圳市华测检测技术股份有限公司
华测检测	深圳市华测检测技术股份有限公司
四川宏达股份有限公司	四川宏达股份有限公司
宏达股份	四川宏达股份有限公司
山东钢铁股份有限公司	山东钢铁股份有限公司
山东钢铁	山东钢铁股份有限公司
昆明卷烟厂	昆明卷烟厂
昆明卷烟厂	昆明卷烟厂
上海黄金交易所	上海黄金交易所
上海黄金交易所	上海黄金交易所
日产汽车公司	日产汽车公司
日产汽车	日产汽车公司
河北衡水老白干酒业股份有限公司	河北衡水老白干酒业股份有限公司
老白干酒	河北衡水老白干酒业股份有限公司
山西西山煤电股份有限公司	山西西山煤电股份有限公司
西山煤电	山西西山煤电股份有限公司
远东实业股份有限公司	远东实业股份有限公司
远东股份	远东实业股份有限公司
河南羚锐制药股份有限公司	河南羚锐制药股份有限公司
羚锐制药.*羚锐股份	河南羚锐制药股份有限公司
法国安盛公司	法国安盛公司
安盛	法国安盛公司
方大集团股份有限公司	方大集团股份有限公司
方大集团.*方大A	方大集团股份有限公司
邵阳网	邵阳网
邵阳网	邵阳网
安徽海螺水泥股份有限公司	安徽海螺水泥股份有限公司
海螺水泥	安徽海螺水泥股份有限公司
北京市大龙伟业房地产开发股份有限公司	北京市大龙伟业房地产开发股份有限公司
大龙地产	北京市大龙伟业房地产开发股份有限公司
南京栖霞建设股份有限公司	南京栖霞建设股份有限公司
栖霞建设	南京栖霞建设股份有限公司
易宝支付	易宝支付
易宝支付	易宝支付
加加食品集团股份有限公司	加加食品集团股份有限公司
加加食品	加加食品集团股份有限公司
河南中原高速公路股份有限公司	河南中原高速公路股份有限公司
中原高速	河南中原高速公路股份有限公司
上海绿新包装材料科技股份有限公司	上海绿新包装材料科技股份有限公司
上海绿新	上海绿新包装材料科技股份有限公司
西藏诺迪康药业股份有限公司	西藏诺迪康药业股份有限公司
西藏药业	西藏诺迪康药业股份有限公司
鲁泰纺织股份有限公司	鲁泰纺织股份有限公司
鲁泰纺织.*鲁泰A.*鲁泰集团.*鲁泰Ａ	鲁泰纺织股份有限公司
东莞证券有限责任公司	东莞证券有限责任公司
东莞证券	东莞证券有限责任公司
江西万年青水泥股份有限公司	江西万年青水泥股份有限公司
江西水泥	江西万年青水泥股份有限公司
胶东在线网站	胶东在线网站
胶东在线	胶东在线网站
鲁南制药集团股份有限公司	鲁南制药集团股份有限公司
鲁南制药	鲁南制药集团股份有限公司
中捷缝纫机股份有限公司	中捷缝纫机股份有限公司
中捷股份	中捷缝纫机股份有限公司
深圳天源迪科信息技术股份有限公司	深圳天源迪科信息技术股份有限公司
天源迪科	深圳天源迪科信息技术股份有限公司
吉林吉恩镍业股份有限公司	吉林吉恩镍业股份有限公司
吉恩镍业	吉林吉恩镍业股份有限公司
哈尔滨工大高新技术产业开发股份有限公司	哈尔滨工大高新技术产业开发股份有限公司
工大高新	哈尔滨工大高新技术产业开发股份有限公司
摩托罗拉公司（Motorola，MOTO，MOTOROLA）	摩托罗拉公司（Motorola，MOTO，MOTOROLA）
摩托罗拉	摩托罗拉公司（Motorola，MOTO，MOTOROLA）
湖南发展集团股份有限公司	湖南发展集团股份有限公司
湖南发展	湖南发展集团股份有限公司
海马汽车集团股份有限公司	海马汽车集团股份有限公司
海马汽车	海马汽车集团股份有限公司
獐子岛集团股份有限公司	獐子岛集团股份有限公司
獐子岛	獐子岛集团股份有限公司
恒宝股份有限公司	恒宝股份有限公司
恒宝股份	恒宝股份有限公司
中国日报网环球在线	中国日报网环球在线
中国日报网环球在线	中国日报网环球在线
海信信芯科技有限公司	海信信芯科技有限公司
海信信芯	海信信芯科技有限公司
深圳中浩(集团)股份有限公司	深圳中浩(集团)股份有限公司
深中浩	深圳中浩(集团)股份有限公司
中航三鑫股份有限公司	中航三鑫股份有限公司
中航三鑫	中航三鑫股份有限公司
上海陆家嘴金融贸易区开发股份有限公司	上海陆家嘴金融贸易区开发股份有限公司
陆家嘴	上海陆家嘴金融贸易区开发股份有限公司
达能集团	达能集团
达能集团	达能集团
圣达特Cendant集团	圣达特Cendant集团
圣达特	圣达特Cendant集团
浙江万里扬变速器股份有限公司	浙江万里扬变速器股份有限公司
万里扬	浙江万里扬变速器股份有限公司
中国南玻集团股份有限公司	中国南玻集团股份有限公司
南玻集团.*南玻A.*南玻Ａ	中国南玻集团股份有限公司
杭州海康威视数字技术股份有限公司	杭州海康威视数字技术股份有限公司
海康威视	杭州海康威视数字技术股份有限公司
惠普研发有限合伙公司	惠普研发有限合伙公司
惠普	惠普研发有限合伙公司
中国铁路通信信号集团公司	中国铁路通信信号集团公司
中国通号	中国铁路通信信号集团公司
渤海轮渡股份有限公司	渤海轮渡股份有限公司
渤海轮渡	渤海轮渡股份有限公司
海南海药股份有限公司	海南海药股份有限公司
海南海药	海南海药股份有限公司
厦门国贸集团股份有限公司	厦门国贸集团股份有限公司
厦门国贸	厦门国贸集团股份有限公司
帝国烟草公司	帝国烟草公司
帝国烟草	帝国烟草公司
摩根大通银行	摩根大通银行
摩根大通	摩根大通银行
杭州中恒电气股份有限公司	杭州中恒电气股份有限公司
中恒电气	杭州中恒电气股份有限公司
瑞泰科技股份有限公司	瑞泰科技股份有限公司
瑞泰科技	瑞泰科技股份有限公司
山东威高集团医用高分子制品股份有限公司	山东威高集团医用高分子制品股份有限公司
山东威高集团	山东威高集团医用高分子制品股份有限公司
宁波维科精华集团股份有限公司	宁波维科精华集团股份有限公司
维科精华	宁波维科精华集团股份有限公司
华硕电脑股份有限公司	华硕电脑股份有限公司
华硕	华硕电脑股份有限公司
银基烯碳新材料股份有限公司	银基烯碳新材料股份有限公司
烯碳新材	银基烯碳新材料股份有限公司
楚天都市报	楚天都市报
楚天都市报	楚天都市报
天津国能投资有限公司	天津国能投资有限公司
国能投资	天津国能投资有限公司
中国武夷实业股份有限公司	中国武夷实业股份有限公司
中国武夷	中国武夷实业股份有限公司
茶易小铺	茶易小铺
茶易小铺	茶易小铺
上海龙头集团股份有限公司	上海龙头集团股份有限公司
龙头股份	上海龙头集团股份有限公司
国金证券股份有限公司	国金证券股份有限公司
国金证券	国金证券股份有限公司
晋商银行股份有限公司	晋商银行股份有限公司
晋商银行	晋商银行股份有限公司
华硕电脑总公司	华硕电脑总公司
华硕电脑	华硕电脑总公司
浙江棒杰数码针织品股份有限公司	浙江棒杰数码针织品股份有限公司
棒杰股份	浙江棒杰数码针织品股份有限公司
江苏亚星锚链股份有限公司	江苏亚星锚链股份有限公司
亚星锚链	江苏亚星锚链股份有限公司
山西杏花村汾酒厂股份有限公司	山西杏花村汾酒厂股份有限公司
山西汾酒	山西杏花村汾酒厂股份有限公司
广东安居宝数码科技股份有限公司	广东安居宝数码科技股份有限公司
安居宝	广东安居宝数码科技股份有限公司
邯郸钢铁股份有限公司	邯郸钢铁股份有限公司
邯郸钢铁	邯郸钢铁股份有限公司
山东华力电机集团股份有限公司	山东华力电机集团股份有限公司
华力电机	山东华力电机集团股份有限公司
北京君正集成电路股份有限公司	北京君正集成电路股份有限公司
北京君正	北京君正集成电路股份有限公司
江苏太平洋精锻科技股份有限公司	江苏太平洋精锻科技股份有限公司
精锻科技	江苏太平洋精锻科技股份有限公司
美国西斯科公司	美国西斯科公司
西斯科	美国西斯科公司
深圳华侨城股份有限公司	深圳华侨城股份有限公司
华侨城.*华侨城Ａ	深圳华侨城股份有限公司
四川新闻网	四川新闻网
四川新闻网	四川新闻网
中源协和干细胞生物工程股份公司	中源协和干细胞生物工程股份公司
中源协和.*ST中源	中源协和干细胞生物工程股份公司
浙江众合机电股份有限公司	浙江众合机电股份有限公司
众合机电	浙江众合机电股份有限公司
杭州华星创业通信技术股份有限公司	杭州华星创业通信技术股份有限公司
华星创业	杭州华星创业通信技术股份有限公司
佛山市国星光电股份有限公司	佛山市国星光电股份有限公司
国星光电	佛山市国星光电股份有限公司
厦门星鲨实业总公司	厦门星鲨实业总公司
星鲨实业	厦门星鲨实业总公司
舜元实业发展股份有限公司	舜元实业发展股份有限公司
舜元实业.*S舜元	舜元实业发展股份有限公司
北京神州绿盟信息安全科技股份有限公司	北京神州绿盟信息安全科技股份有限公司
绿盟科技	北京神州绿盟信息安全科技股份有限公司
展讯通信有限公司	展讯通信有限公司
展讯通信	展讯通信有限公司
大连三垒机器股份有限公司	大连三垒机器股份有限公司
大连三垒	大连三垒机器股份有限公司
常州千红生化制药股份有限公司	常州千红生化制药股份有限公司
千红制药	常州千红生化制药股份有限公司
宁波GQY视讯股份有限公司	宁波GQY视讯股份有限公司
GQY视讯	宁波GQY视讯股份有限公司
集富亚洲	集富亚洲
集富亚洲	集富亚洲
深圳市齐心文具股份有限公司	深圳市齐心文具股份有限公司
齐心文具	深圳市齐心文具股份有限公司
广东奥飞动漫文化股份有限公司	广东奥飞动漫文化股份有限公司
奥飞动漫	广东奥飞动漫文化股份有限公司
深圳信隆实业股份有限公司	深圳信隆实业股份有限公司
信隆实业	深圳信隆实业股份有限公司
广誉远中药股份有限公司	广誉远中药股份有限公司
广誉远	广誉远中药股份有限公司
贵州轮胎股份有限公司	贵州轮胎股份有限公司
黔轮胎.*黔轮胎Ａ	贵州轮胎股份有限公司
上海外高桥保税区开发股份有限公司	上海外高桥保税区开发股份有限公司
外高桥	上海外高桥保税区开发股份有限公司
德国巴登-符腾堡州银行	德国巴登-符腾堡州银行
巴登符腾堡州银行	德国巴登-符腾堡州银行
日本三菱商事股份有限公司	日本三菱商事股份有限公司
三菱商事	日本三菱商事股份有限公司
南宁八菱科技股份有限公司	南宁八菱科技股份有限公司
八菱科技	南宁八菱科技股份有限公司
南京华东电子信息科技股份有限公司	南京华东电子信息科技股份有限公司
华东科技	南京华东电子信息科技股份有限公司
海口农工贸罗牛山股份有限公司	海口农工贸罗牛山股份有限公司
罗牛山	海口农工贸罗牛山股份有限公司
华夏航空有限公司	华夏航空有限公司
华夏航空	华夏航空有限公司
江苏金通灵流体机械科技股份有限公司	江苏金通灵流体机械科技股份有限公司
金通灵	江苏金通灵流体机械科技股份有限公司
海欣食品股份有限公司	海欣食品股份有限公司
海欣食品	海欣食品股份有限公司
新疆天山畜牧生物工程股份有限公司	新疆天山畜牧生物工程股份有限公司
天山生物	新疆天山畜牧生物工程股份有限公司
山东天业恒基股份有限公司	山东天业恒基股份有限公司
天业股份	山东天业恒基股份有限公司
TCL集团股份有限公司	TCL集团股份有限公司
TCL集团.*TCL	TCL集团股份有限公司
东吴证券有限责任公司	东吴证券有限责任公司
东吴证券	东吴证券有限责任公司
长江实业（集团）有限公司	长江实业（集团）有限公司
长江实业	长江实业（集团）有限公司
河北汇金机电股份有限公司	河北汇金机电股份有限公司
汇金股份	河北汇金机电股份有限公司
广东省宜华木业股份有限公司	广东省宜华木业股份有限公司
宜华木业	广东省宜华木业股份有限公司
美联银行	美联银行
美联银行	美联银行
衡阳市金荔科技农业股份有限公司	衡阳市金荔科技农业股份有限公司
金荔科技	衡阳市金荔科技农业股份有限公司
德同资本	德同资本
德同资本	德同资本
中弘控股股份有限公司	中弘控股股份有限公司
中弘股份	中弘控股股份有限公司
西南合成制药股份有限公司	西南合成制药股份有限公司
西南合成	西南合成制药股份有限公司
湖南中科电气股份有限公司	湖南中科电气股份有限公司
中科电气.*湖南中科	湖南中科电气股份有限公司
法国国家人寿保险公司	法国国家人寿保险公司
CNP	法国国家人寿保险公司
利宝保险有限公司	利宝保险有限公司
利宝保险	利宝保险有限公司
浙江省围海建设集团股份有限公司	浙江省围海建设集团股份有限公司
围海股份	浙江省围海建设集团股份有限公司
锦江国际集团有限公司	锦江国际集团有限公司
锦江国际集团	锦江国际集团有限公司
南方人物周刊	南方人物周刊
南方人物周刊	南方人物周刊
广州珠江钢琴集团股份有限公司	广州珠江钢琴集团股份有限公司
珠江钢琴	广州珠江钢琴集团股份有限公司
上海汽车集团股份有限公司	上海汽车集团股份有限公司
上汽集团	上海汽车集团股份有限公司
中华企业股份有限公司	中华企业股份有限公司
中华企业	中华企业股份有限公司
泰达荷银基金管理有限公司	泰达荷银基金管理有限公司
泰达荷银基金	泰达荷银基金管理有限公司
北京汇冠新技术股份有限公司	北京汇冠新技术股份有限公司
汇冠股份	北京汇冠新技术股份有限公司
中国软件与技术服务股份有限公司	中国软件与技术服务股份有限公司
中国软件	中国软件与技术服务股份有限公司
海南神农大丰种业科技股份有限公司	海南神农大丰种业科技股份有限公司
神农大丰	海南神农大丰种业科技股份有限公司
深圳市奥拓电子股份有限公司	深圳市奥拓电子股份有限公司
奥拓电子	深圳市奥拓电子股份有限公司
浙江物产中大元通集团股份有限公司	浙江物产中大元通集团股份有限公司
物产中大	浙江物产中大元通集团股份有限公司
方正证券	方正证券
方正证券	方正证券
新兴铸管股份有限公司	新兴铸管股份有限公司
新兴铸管	新兴铸管股份有限公司
上海证券交易所	上海证券交易所
上证所	上海证券交易所
浪潮电子信息产业股份有限公司	浪潮电子信息产业股份有限公司
浪潮信息	浪潮电子信息产业股份有限公司
上海市天宸股份有限公司	上海市天宸股份有限公司
天宸股份	上海市天宸股份有限公司
陕西煤航数码测绘集团股份有限公司	陕西煤航数码测绘集团股份有限公司
\\*ST数码	陕西煤航数码测绘集团股份有限公司
深圳市信维通信股份有限公司	深圳市信维通信股份有限公司
信维通信	深圳市信维通信股份有限公司
百仕达地产有限公司	百仕达地产有限公司
百仕达	百仕达地产有限公司
数字商业时代	数字商业时代
数字商业时代	数字商业时代
山东济宁如意毛纺织股份有限公司	山东济宁如意毛纺织股份有限公司
山东如意	山东济宁如意毛纺织股份有限公司
人本集团	人本集团
人本集团	人本集团
宁波联合建设开发有限公司	宁波联合建设开发有限公司
联合地产	宁波联合建设开发有限公司
大连友谊(集团)股份有限公司	大连友谊(集团)股份有限公司
大连友谊	大连友谊(集团)股份有限公司
四川出版集团	四川出版集团
四川出版集团	四川出版集团
广东万家乐股份有限公司	广东万家乐股份有限公司
万家乐	广东万家乐股份有限公司
康美药业股份有限公司	康美药业股份有限公司
康美药业	康美药业股份有限公司
山东瑞丰高分子材料股份有限公司	山东瑞丰高分子材料股份有限公司
瑞丰高材	山东瑞丰高分子材料股份有限公司
厦门华侨电子企业有限公司	厦门华侨电子企业有限公司
厦华电子	厦门华侨电子企业有限公司
中国气象报	中国气象报
中国气象报	中国气象报
湖南长高高压开关集团股份公司	湖南长高高压开关集团股份公司
长高集团	湖南长高高压开关集团股份公司
深圳市惠程电气股份有限公司	深圳市惠程电气股份有限公司
深圳惠程	深圳市惠程电气股份有限公司
江苏华厦融创置地集团有限公司	江苏华厦融创置地集团有限公司
华厦融创	江苏华厦融创置地集团有限公司
河南思达高科技股份有限公司	河南思达高科技股份有限公司
思达高科.*\\*ST思达	河南思达高科技股份有限公司
太原重工股份有限公司	太原重工股份有限公司
太原重工	太原重工股份有限公司
江苏永鼎股份有限公司	江苏永鼎股份有限公司
永鼎股份	江苏永鼎股份有限公司
香格里拉亚洲有限公司	香格里拉亚洲有限公司
香格里拉	香格里拉亚洲有限公司
深圳市格林美高新技术股份有限公司	深圳市格林美高新技术股份有限公司
格林美	深圳市格林美高新技术股份有限公司
兰州长城电工股份有限公司	兰州长城电工股份有限公司
长城电工	兰州长城电工股份有限公司
保时捷公司	保时捷公司
保时捷	保时捷公司
兰州民百集团股份有限公司	兰州民百集团股份有限公司
兰州民百	兰州民百集团股份有限公司
河南省中原内配股份有限公司	河南省中原内配股份有限公司
中原内配	河南省中原内配股份有限公司
山东华鲁恒升化工股份有限公司	山东华鲁恒升化工股份有限公司
华鲁恒升	山东华鲁恒升化工股份有限公司
广州广电运通金融电子股份有限公司	广州广电运通金融电子股份有限公司
广电运通	广州广电运通金融电子股份有限公司
广东电力发展股份有限公司	广东电力发展股份有限公司
粤电力.*粤电力A.*粤电力Ａ	广东电力发展股份有限公司
浙江新和成股份有限公司	浙江新和成股份有限公司
新和成	浙江新和成股份有限公司
四川舒卡特种纤维股份有限公司	四川舒卡特种纤维股份有限公司
舒卡股份	四川舒卡特种纤维股份有限公司
苏州罗普斯金铝业股份有限公司	苏州罗普斯金铝业股份有限公司
罗普斯金	苏州罗普斯金铝业股份有限公司
新疆国际实业股份有限公司	新疆国际实业股份有限公司
国际实业	新疆国际实业股份有限公司
安源煤业集团股份有限公司	安源煤业集团股份有限公司
安源煤业	安源煤业集团股份有限公司
江苏飞力达国际物流股份有限公司	江苏飞力达国际物流股份有限公司
飞力达	江苏飞力达国际物流股份有限公司
闽西新闻网	闽西新闻网
闽西新闻网	闽西新闻网
广州东凌粮油股份有限公司	广州东凌粮油股份有限公司
东凌粮油	广州东凌粮油股份有限公司
阳煤化工股份有限公司	阳煤化工股份有限公司
阳煤化工	阳煤化工股份有限公司
江苏中南建设集团股份有限公司	江苏中南建设集团股份有限公司
中南建设	江苏中南建设集团股份有限公司
罗莱家纺股份有限公司	罗莱家纺股份有限公司
罗莱家纺	罗莱家纺股份有限公司
河南通达电缆股份有限公司	河南通达电缆股份有限公司
通达股份	河南通达电缆股份有限公司
合众人寿保险股份有限公司	合众人寿保险股份有限公司
合众人寿	合众人寿保险股份有限公司
吉林成城集团股份有限公司	吉林成城集团股份有限公司
成城股份	吉林成城集团股份有限公司
广东长青(集团)股份有限公司	广东长青(集团)股份有限公司
长青集团	广东长青(集团)股份有限公司
陕西秦川机床集团有限公司	陕西秦川机床集团有限公司
秦川机床	陕西秦川机床集团有限公司
北京福星晓程电子科技股份有限公司	北京福星晓程电子科技股份有限公司
福星晓程	北京福星晓程电子科技股份有限公司
中农发种业集团股份有限公司	中农发种业集团股份有限公司
农发种业	中农发种业集团股份有限公司
上海科华生物工程股份有限公司	上海科华生物工程股份有限公司
科华生物	上海科华生物工程股份有限公司
海南海峡航运股份有限公司	海南海峡航运股份有限公司
海峡股份	海南海峡航运股份有限公司
迈克科技有限责任公司	迈克科技有限责任公司
迈克科技	迈克科技有限责任公司
济南二机床集团	济南二机床集团
济南二机床	济南二机床集团
环球财经	环球财经
环球财经	环球财经
山东鲁北化工股份有限公司	山东鲁北化工股份有限公司
鲁北化工	山东鲁北化工股份有限公司
长岭集团股份有限公司	长岭集团股份有限公司
S\\*ST长岭	长岭集团股份有限公司
长春经开(集团)股份有限公司	长春经开(集团)股份有限公司
长春经开	长春经开(集团)股份有限公司
吉艾科技(北京)股份公司	吉艾科技(北京)股份公司
吉艾科技	吉艾科技(北京)股份公司
楚天科技股份有限公司	楚天科技股份有限公司
楚天科技	楚天科技股份有限公司
三诺生物传感股份有限公司	三诺生物传感股份有限公司
三诺生物	三诺生物传感股份有限公司
上海复星医药(集团)股份有限公司	上海复星医药(集团)股份有限公司
复星医药	上海复星医药(集团)股份有限公司
号百控股股份有限公司	号百控股股份有限公司
号百控股	号百控股股份有限公司
银泰资源股份有限公司	银泰资源股份有限公司
银泰资源	银泰资源股份有限公司
亚马逊公司	亚马逊公司
亚马逊	亚马逊公司
三角集团有限公司	三角集团有限公司
三角集团	三角集团有限公司
百胜餐饮集团	百胜餐饮集团
百胜餐饮	百胜餐饮集团
索迪斯集团	索迪斯集团
索迪斯	索迪斯集团
杭州远方光电信息股份有限公司	杭州远方光电信息股份有限公司
远方光电	杭州远方光电信息股份有限公司
北京东方国信科技股份有限公司	北京东方国信科技股份有限公司
东方国信	北京东方国信科技股份有限公司
广州药业股份有限公司	广州药业股份有限公司
广州药业	广州药业股份有限公司
河南省西保冶材集团有限公司	河南省西保冶材集团有限公司
西保集团	河南省西保冶材集团有限公司
飞亚达(集团)股份有限公司	飞亚达(集团)股份有限公司
飞亚达	飞亚达(集团)股份有限公司
重庆钢铁（集团）有限责任公司	重庆钢铁（集团）有限责任公司
重钢集团	重庆钢铁（集团）有限责任公司
沙河实业股份有限公司	沙河实业股份有限公司
沙河股份	沙河实业股份有限公司
新疆机械研究院股份有限公司	新疆机械研究院股份有限公司
新研股份	新疆机械研究院股份有限公司
广州恒大实业集团有限公司	广州恒大实业集团有限公司
恒大实业	广州恒大实业集团有限公司
浙江世纪华通车业股份有限公司	浙江世纪华通车业股份有限公司
世纪华通	浙江世纪华通车业股份有限公司
恒立实业发展集团股份有限公司	恒立实业发展集团股份有限公司
恒立实业	恒立实业发展集团股份有限公司
三力士股份有限公司	三力士股份有限公司
三力士	三力士股份有限公司
青岛海尔股份有限公司	青岛海尔股份有限公司
青岛海尔.*海尔	青岛海尔股份有限公司
广州市香雪制药股份有限公司	广州市香雪制药股份有限公司
香雪制药	广州市香雪制药股份有限公司
北京城乡贸易中心股份有限公司	北京城乡贸易中心股份有限公司
北京城乡	北京城乡贸易中心股份有限公司
佳通轮胎股份有限公司	佳通轮胎股份有限公司
佳通轮胎	佳通轮胎股份有限公司
广东华声电器股份有限公司	广东华声电器股份有限公司
华声股份	广东华声电器股份有限公司
北京天坛生物制品股份有限公司	北京天坛生物制品股份有限公司
天坛生物	北京天坛生物制品股份有限公司
烟台万华聚氨酯股份有限公司	烟台万华聚氨酯股份有限公司
烟台万华	烟台万华聚氨酯股份有限公司
厦门钨业股份有限公司	厦门钨业股份有限公司
厦门钨业	厦门钨业股份有限公司
深圳石化工业集团股份有限公司	深圳石化工业集团股份有限公司
深石化.*\\*ST石化A	深圳石化工业集团股份有限公司
东兴证券股份有限公司	东兴证券股份有限公司
东兴证券	东兴证券股份有限公司
大都会人寿保险公司（MetLife）	大都会人寿保险公司（MetLife）
大都会人寿	大都会人寿保险公司（MetLife）
北京旋极信息技术股份有限公司	北京旋极信息技术股份有限公司
旋极信息	北京旋极信息技术股份有限公司
江苏奥赛康药业股份有限公司	江苏奥赛康药业股份有限公司
奥赛康	江苏奥赛康药业股份有限公司
千足珍珠集团股份有限公司	千足珍珠集团股份有限公司
千足珍珠	千足珍珠集团股份有限公司
北京三元食品股份有限公司	北京三元食品股份有限公司
三元股份	北京三元食品股份有限公司
甘肃莫高实业发展股份有限公司	甘肃莫高实业发展股份有限公司
莫高股份	甘肃莫高实业发展股份有限公司
道明光学股份有限公司	道明光学股份有限公司
道明光学	道明光学股份有限公司
浙江奥康鞋业股份有限公司	浙江奥康鞋业股份有限公司
奥康国际	浙江奥康鞋业股份有限公司
浙商证券有限责任公司	浙商证券有限责任公司
浙商证券	浙商证券有限责任公司
中卫国脉通信股份有限公司	中卫国脉通信股份有限公司
中卫国脉	中卫国脉通信股份有限公司
深圳市新国都技术股份有限公司	深圳市新国都技术股份有限公司
新国都	深圳市新国都技术股份有限公司
银川新华百货商业集团股份有限公司	银川新华百货商业集团股份有限公司
新华百货	银川新华百货商业集团股份有限公司
济南柴油机股份有限公司	济南柴油机股份有限公司
济柴股份.*石油济柴.*\\*ST济柴	济南柴油机股份有限公司
青海贤成矿业股份有限公司	青海贤成矿业股份有限公司
贤成矿业.*ST贤成	青海贤成矿业股份有限公司
瑞安建业有限公司	瑞安建业有限公司
瑞安建业	瑞安建业有限公司
辽宁聚龙金融设备股份有限公司	辽宁聚龙金融设备股份有限公司
聚龙股份	辽宁聚龙金融设备股份有限公司
深圳市物业发展(集团)股份有限公司	深圳市物业发展(集团)股份有限公司
深物业.*深物业A	深圳市物业发展(集团)股份有限公司
金沙江创业投资基金	金沙江创业投资基金
金沙江创投	金沙江创业投资基金
广西新闻网	广西新闻网
广西新闻网	广西新闻网
云南绿大地生物科技股份有限公司	云南绿大地生物科技股份有限公司
绿大地.*\\*ST大地	云南绿大地生物科技股份有限公司
中国船舶工业股份有限公司	中国船舶工业股份有限公司
中国船舶	中国船舶工业股份有限公司
中信国安葡萄酒业股份有限公司	中信国安葡萄酒业股份有限公司
中葡股份	中信国安葡萄酒业股份有限公司
南方网－南方日报	南方网－南方日报
南方日报	南方网－南方日报
晨光生物科技集团股份有限公司	晨光生物科技集团股份有限公司
晨光生物	晨光生物科技集团股份有限公司
梅花伞业股份有限公司	梅花伞业股份有限公司
梅花伞	梅花伞业股份有限公司
天音通信控股股份有限公司	天音通信控股股份有限公司
天音控股	天音通信控股股份有限公司
都邦财产保险股份有限公司	都邦财产保险股份有限公司
都邦保险	都邦财产保险股份有限公司
中国燃气控股有限公司	中国燃气控股有限公司
中国燃气	中国燃气控股有限公司
长春北方五环实业股份有限公司	长春北方五环实业股份有限公司
北方五环	长春北方五环实业股份有限公司
中美大都会人寿保险有限公司	中美大都会人寿保险有限公司
中美大都会人寿	中美大都会人寿保险有限公司
甘肃荣华实业(集团)股份有限公司	甘肃荣华实业(集团)股份有限公司
荣华实业	甘肃荣华实业(集团)股份有限公司
中粮地产集团股份有限公司	中粮地产集团股份有限公司
中粮地产	中粮地产集团股份有限公司
北京钢研高纳科技股份有限公司	北京钢研高纳科技股份有限公司
钢研高纳	北京钢研高纳科技股份有限公司
湖南南岭民用爆破器材股份有限公司	湖南南岭民用爆破器材股份有限公司
南岭民爆	湖南南岭民用爆破器材股份有限公司
丹东欣泰电气股份有限公司	丹东欣泰电气股份有限公司
欣泰电气	丹东欣泰电气股份有限公司
西安曲江文化旅游股份有限公司	西安曲江文化旅游股份有限公司
曲江文旅	西安曲江文化旅游股份有限公司
银川新华百货商店股份有限公司	银川新华百货商店股份有限公司
新华百货	银川新华百货商店股份有限公司
中建西部建设股份有限公司	中建西部建设股份有限公司
西部建设	中建西部建设股份有限公司
中国工商银行股份有限公司	中国工商银行股份有限公司
工商银行	中国工商银行股份有限公司
中兴-沈阳商业大厦(集团)股份有限公司	中兴-沈阳商业大厦(集团)股份有限公司
中兴商业	中兴-沈阳商业大厦(集团)股份有限公司
福建达利集团	福建达利集团
达利集团	福建达利集团
安徽巢东水泥股份有限公司	安徽巢东水泥股份有限公司
巢东股份	安徽巢东水泥股份有限公司
北京中踏鞋业有限公司	北京中踏鞋业有限公司
中踏鞋业	北京中踏鞋业有限公司
无锡宝通带业股份有限公司	无锡宝通带业股份有限公司
宝通带业	无锡宝通带业股份有限公司
江苏豪森药业股份有限公司	江苏豪森药业股份有限公司
豪森药业	江苏豪森药业股份有限公司
金瑞新材料科技股份有限公司	金瑞新材料科技股份有限公司
金瑞科技	金瑞新材料科技股份有限公司
陕西省天然气股份有限公司	陕西省天然气股份有限公司
陕天然气	陕西省天然气股份有限公司
江西博雅生物制药股份有限公司	江西博雅生物制药股份有限公司
博雅生物	江西博雅生物制药股份有限公司
山东电视台	山东电视台
山东电视台	山东电视台
内蒙古蒙电华能热电股份有限公司	内蒙古蒙电华能热电股份有限公司
内蒙华电	内蒙古蒙电华能热电股份有限公司
重庆建设工业有限责任公司	重庆建设工业有限责任公司
建设工业	重庆建设工业有限责任公司
无锡百川化工股份有限公司	无锡百川化工股份有限公司
百川股份	无锡百川化工股份有限公司
杭州顺网科技股份有限公司	杭州顺网科技股份有限公司
顺网科技	杭州顺网科技股份有限公司
荣丰控股集团股份有限公司	荣丰控股集团股份有限公司
荣丰控股	荣丰控股集团股份有限公司
吉林化学工业股份有限公司	吉林化学工业股份有限公司
吉林化工	吉林化学工业股份有限公司
日本关西电力公司	日本关西电力公司
关西电力	日本关西电力公司
北京电子城投资开发股份有限公司	北京电子城投资开发股份有限公司
电子城	北京电子城投资开发股份有限公司
民生加银基金管理有限公司	民生加银基金管理有限公司
民生加银	民生加银基金管理有限公司
江苏扬力集团有限公司	江苏扬力集团有限公司
扬力集团	江苏扬力集团有限公司
河南四方达超硬材料股份有限公司	河南四方达超硬材料股份有限公司
四方达	河南四方达超硬材料股份有限公司
淮南矿业集团有限责任公司	淮南矿业集团有限责任公司
淮南矿业	淮南矿业集团有限责任公司
中兴-沈阳商业大厦（集团）股份有限公司	中兴-沈阳商业大厦（集团）股份有限公司
中兴商业	中兴-沈阳商业大厦（集团）股份有限公司
杭州炬华科技股份有限公司	杭州炬华科技股份有限公司
炬华科技	杭州炬华科技股份有限公司
重庆桐君阁股份有限公司	重庆桐君阁股份有限公司
桐君阁	重庆桐君阁股份有限公司
湖北回天胶业股份有限公司	湖北回天胶业股份有限公司
回天胶业	湖北回天胶业股份有限公司
安徽丰原药业股份有限公司	安徽丰原药业股份有限公司
丰原药业	安徽丰原药业股份有限公司
上海国际机场股份有限公司	上海国际机场股份有限公司
上海机场	上海国际机场股份有限公司
四川汇源光通信股份有限公司	四川汇源光通信股份有限公司
汇源通信	四川汇源光通信股份有限公司
中国大地财产保险股份有限公司	中国大地财产保险股份有限公司
大地财险	中国大地财产保险股份有限公司
辽宁大金重工股份有限公司	辽宁大金重工股份有限公司
大金重工	辽宁大金重工股份有限公司
荣信电力电子股份有限公司	荣信电力电子股份有限公司
荣信股份	荣信电力电子股份有限公司
首创置业股份有限公司	首创置业股份有限公司
首创置业	首创置业股份有限公司
摩根士丹利华鑫基金管理有限公司	摩根士丹利华鑫基金管理有限公司
摩根士丹利华鑫.*摩根士丹利华鑫基金	摩根士丹利华鑫基金管理有限公司
海康人寿保险有限公司	海康人寿保险有限公司
海康人寿	海康人寿保险有限公司
上海电力股份有限公司	上海电力股份有限公司
上海电力	上海电力股份有限公司
台湾中油股份有限公司	台湾中油股份有限公司
中油公司	台湾中油股份有限公司
申万菱信基金管理有限公司	申万菱信基金管理有限公司
申万菱信	申万菱信基金管理有限公司
北京大北农科技集团股份有限公司	北京大北农科技集团股份有限公司
大北农	北京大北农科技集团股份有限公司
特变电工股份有限公司	特变电工股份有限公司
特变电工	特变电工股份有限公司
BainCapital	BainCapital
贝恩资本	BainCapital
通化葡萄酒股份有限公司	通化葡萄酒股份有限公司
通葡股份	通化葡萄酒股份有限公司
广西贵糖(集团)股份有限公司	广西贵糖(集团)股份有限公司
贵糖股份	广西贵糖(集团)股份有限公司
厦门港务发展股份有限公司	厦门港务发展股份有限公司
厦门港务	厦门港务发展股份有限公司
苏宁云商集团股份有限公司	苏宁云商集团股份有限公司
苏宁云商	苏宁云商集团股份有限公司
重庆长安汽车股份有限公司	重庆长安汽车股份有限公司
长安汽车	重庆长安汽车股份有限公司
南京欣网视讯科技股份有限公司	南京欣网视讯科技股份有限公司
欣网视讯	南京欣网视讯科技股份有限公司
上海丰华集团股份有限公司	上海丰华集团股份有限公司
丰华股份	上海丰华集团股份有限公司
湖北博盈投资股份有限公司	湖北博盈投资股份有限公司
博盈投资	湖北博盈投资股份有限公司
深圳市赛为智能股份有限公司	深圳市赛为智能股份有限公司
赛为智能	深圳市赛为智能股份有限公司
东星航空有限公司	东星航空有限公司
东星航空	东星航空有限公司
中国建筑股份有限公司	中国建筑股份有限公司
中国建筑	中国建筑股份有限公司
新疆库尔勒香梨股份有限公司	新疆库尔勒香梨股份有限公司
香梨股份	新疆库尔勒香梨股份有限公司
厦门机电集团有限公司	厦门机电集团有限公司
厦门机电	厦门机电集团有限公司
山东海龙股份有限公司	山东海龙股份有限公司
山东海龙	山东海龙股份有限公司
浙江世宝股份有限公司	浙江世宝股份有限公司
浙江世宝	浙江世宝股份有限公司
永泰能源股份有限公司	永泰能源股份有限公司
永泰能源	永泰能源股份有限公司
时代华纳公司（TimeWarnerInc.）	时代华纳公司（TimeWarnerInc.）
时代华纳	时代华纳公司（TimeWarnerInc.）
北京神州泰岳软件股份有限公司	北京神州泰岳软件股份有限公司
神州泰岳	北京神州泰岳软件股份有限公司
河南辉煌科技股份有限公司	河南辉煌科技股份有限公司
辉煌科技	河南辉煌科技股份有限公司
东方网力科技股份有限公司	东方网力科技股份有限公司
东方网力	东方网力科技股份有限公司
深圳市德赛电池科技股份有限公司	深圳市德赛电池科技股份有限公司
德赛电池	深圳市德赛电池科技股份有限公司
天威英利新能源有限公司	天威英利新能源有限公司
天威英利	天威英利新能源有限公司
北京汽车工业控股有限责任公司	北京汽车工业控股有限责任公司
北汽集团	北京汽车工业控股有限责任公司
浙江南都电源动力股份有限公司	浙江南都电源动力股份有限公司
南都电源	浙江南都电源动力股份有限公司
AbbottLaboratories	AbbottLaboratories
雅培	AbbottLaboratories
上海宽频科技股份有限公司	上海宽频科技股份有限公司
上海科技	上海宽频科技股份有限公司
第一拖拉机股份有限公司	第一拖拉机股份有限公司
一拖股份	第一拖拉机股份有限公司
济南轻骑摩托车股份有限公司	济南轻骑摩托车股份有限公司
ST轻骑	济南轻骑摩托车股份有限公司
温州宏丰电工合金股份有限公司	温州宏丰电工合金股份有限公司
温州宏丰	温州宏丰电工合金股份有限公司
四川美丰化工股份有限公司	四川美丰化工股份有限公司
四川美丰	四川美丰化工股份有限公司
中国泛海控股集团	中国泛海控股集团
中国泛海	中国泛海控股集团
山东新能泰山发电股份有限公司	山东新能泰山发电股份有限公司
新能泰山	山东新能泰山发电股份有限公司
长春高新技术产业（集团）股份有限公司	长春高新技术产业（集团）股份有限公司
长春高新	长春高新技术产业（集团）股份有限公司
深圳市飞马国际供应链股份有限公司	深圳市飞马国际供应链股份有限公司
飞马国际	深圳市飞马国际供应链股份有限公司
上海嘉宝实业集团股份有限公司	上海嘉宝实业集团股份有限公司
嘉宝集团	上海嘉宝实业集团股份有限公司
魏桥纺织股份有限公司	魏桥纺织股份有限公司
魏桥纺织	魏桥纺织股份有限公司
四川浩物机电股份有限公司	四川浩物机电股份有限公司
浩物股份	四川浩物机电股份有限公司
上海辅仁实业(集团)股份有限公司	上海辅仁实业(集团)股份有限公司
上海辅仁	上海辅仁实业(集团)股份有限公司
成都博瑞传播股份有限公司	成都博瑞传播股份有限公司
博瑞传播	成都博瑞传播股份有限公司
中信国安信息产业股份有限公司	中信国安信息产业股份有限公司
中信国安	中信国安信息产业股份有限公司
合肥美菱股份有限公司	合肥美菱股份有限公司
美菱电器	合肥美菱股份有限公司
广东喜之郎集团有限公司	广东喜之郎集团有限公司
喜之郎	广东喜之郎集团有限公司
新疆八一钢铁股份有限公司	新疆八一钢铁股份有限公司
八一钢铁	新疆八一钢铁股份有限公司
奇瑞汽车股份有限公司	奇瑞汽车股份有限公司
奇瑞汽车	奇瑞汽车股份有限公司
徐州工程机械集团	徐州工程机械集团
徐工集团	徐州工程机械集团
西部金属材料股份有限公司	西部金属材料股份有限公司
西部材料	西部金属材料股份有限公司
陕西煤航数码测绘(集团)股份有限公司	陕西煤航数码测绘(集团)股份有限公司
数码测绘	陕西煤航数码测绘(集团)股份有限公司
大发集团有限公司	大发集团有限公司
大发集团	大发集团有限公司
中国星星集团有限公司	中国星星集团有限公司
星星集团	中国星星集团有限公司
上海大众公用事业(集团)股份有限公司	上海大众公用事业(集团)股份有限公司
大众公用	上海大众公用事业(集团)股份有限公司
苏州东山精密制造股份有限公司	苏州东山精密制造股份有限公司
东山精密	苏州东山精密制造股份有限公司
广西贵糖（集团）股份有限公司	广西贵糖（集团）股份有限公司
贵糖股份	广西贵糖（集团）股份有限公司
融资中国	融资中国
融资中国	融资中国
福建凤竹纺织科技股份有限公司	福建凤竹纺织科技股份有限公司
凤竹纺织	福建凤竹纺织科技股份有限公司
天立环保工程股份有限公司	天立环保工程股份有限公司
天立环保	天立环保工程股份有限公司
杭州娃哈哈集团有限公司	杭州娃哈哈集团有限公司
哇哈哈.*娃哈哈集团	杭州娃哈哈集团有限公司
仲盛集团	仲盛集团
仲盛集团	仲盛集团
内蒙古鄂尔多斯羊绒制品股份有限公司	内蒙古鄂尔多斯羊绒制品股份有限公司
鄂尔多斯	内蒙古鄂尔多斯羊绒制品股份有限公司
中国重汽集团济南卡车股份有限公司	中国重汽集团济南卡车股份有限公司
中国重汽	中国重汽集团济南卡车股份有限公司
海南海岛建设股份有限公司	海南海岛建设股份有限公司
海岛建设	海南海岛建设股份有限公司
顺发恒业股份公司	顺发恒业股份公司
顺发恒业	顺发恒业股份公司
深圳市爱施德股份有限公司	深圳市爱施德股份有限公司
爱施德	深圳市爱施德股份有限公司
中邮创业基金管理有限公司	中邮创业基金管理有限公司
中邮基金	中邮创业基金管理有限公司
信和置业有限公司	信和置业有限公司
信和集团	信和置业有限公司
深圳科士达科技股份有限公司	深圳科士达科技股份有限公司
科士达	深圳科士达科技股份有限公司
比利时德克夏银行	比利时德克夏银行
德克夏银行	比利时德克夏银行
西安饮食股份有限公司	西安饮食股份有限公司
西安饮食	西安饮食股份有限公司
上海搏沪金属贸易有限公司	上海搏沪金属贸易有限公司
搏沪金属	上海搏沪金属贸易有限公司
投资与合作	投资与合作
投资与合作	投资与合作
银华基金管理有限公司	银华基金管理有限公司
银华基金	银华基金管理有限公司
黄山永新股份有限公司	黄山永新股份有限公司
永新股份	黄山永新股份有限公司
大连重工·起重集团有限公司	大连重工·起重集团有限公司
大连重工	大连重工·起重集团有限公司
湖南辰州矿业股份有限公司	湖南辰州矿业股份有限公司
辰州矿业	湖南辰州矿业股份有限公司
北京京西风光旅游开发股份有限公司	北京京西风光旅游开发股份有限公司
北京旅游	北京京西风光旅游开发股份有限公司
深圳丹邦科技股份有限公司	深圳丹邦科技股份有限公司
丹邦科技	深圳丹邦科技股份有限公司
咸阳偏转股份有限公司	咸阳偏转股份有限公司
\\*ST偏转	咸阳偏转股份有限公司
华夏银行股份有限公司	华夏银行股份有限公司
华夏银行	华夏银行股份有限公司
新财经	新财经
新财经	新财经
三菱电机株式会社	三菱电机株式会社
三菱电机	三菱电机株式会社
武汉高德红外股份有限公司	武汉高德红外股份有限公司
高德红外	武汉高德红外股份有限公司
华仪电气股份有限公司	华仪电气股份有限公司
华仪电气	华仪电气股份有限公司
浙江永太科技股份有限公司	浙江永太科技股份有限公司
永太科技	浙江永太科技股份有限公司
英荷皇家壳牌集团	英荷皇家壳牌集团
壳牌公司	英荷皇家壳牌集团
钱经杂志	钱经杂志
钱经	钱经杂志
中铁铁龙集装箱物流股份有限公司	中铁铁龙集装箱物流股份有限公司
铁龙物流	中铁铁龙集装箱物流股份有限公司
航天通信控股集团股份有限公司	航天通信控股集团股份有限公司
航天通信	航天通信控股集团股份有限公司
四川川大智胜软件股份有限公司	四川川大智胜软件股份有限公司
川大智胜	四川川大智胜软件股份有限公司
湖南华菱钢铁集团有限责任公司	湖南华菱钢铁集团有限责任公司
华菱集团	湖南华菱钢铁集团有限责任公司
武汉健民药业集团股份有限公司	武汉健民药业集团股份有限公司
武汉健民	武汉健民药业集团股份有限公司
天治基金管理有限公司	天治基金管理有限公司
天治基金	天治基金管理有限公司
联想集团有限公司	联想集团有限公司
联想	联想集团有限公司
中国长城计算机深圳股份有限公司	中国长城计算机深圳股份有限公司
长城电脑	中国长城计算机深圳股份有限公司
江苏吴通通讯股份有限公司	江苏吴通通讯股份有限公司
吴通通讯	江苏吴通通讯股份有限公司
广东威创视讯科技股份有限公司	广东威创视讯科技股份有限公司
威创股份	广东威创视讯科技股份有限公司
长春燃气股份有限公司	长春燃气股份有限公司
长春燃气	长春燃气股份有限公司
秦皇岛天业通联重工股份有限公司	秦皇岛天业通联重工股份有限公司
天业通联	秦皇岛天业通联重工股份有限公司
环球企业家	环球企业家
环球企业家	环球企业家
上海捷强烟草糖酒集团有限公司	上海捷强烟草糖酒集团有限公司
捷强集团	上海捷强烟草糖酒集团有限公司
沈阳机床股份有限公司	沈阳机床股份有限公司
沈阳机床	沈阳机床股份有限公司
华北制药股份有限公司	华北制药股份有限公司
华北制药	华北制药股份有限公司
莱芜钢铁股份有限公司	莱芜钢铁股份有限公司
莱钢股份	莱芜钢铁股份有限公司
青岛宏大纺织机械有限责任公司	青岛宏大纺织机械有限责任公司
青岛宏大	青岛宏大纺织机械有限责任公司
北京首都创业集团有限公司	北京首都创业集团有限公司
首创集团	北京首都创业集团有限公司
西部商报	西部商报
西部商报	西部商报
洛阳轴研科技股份有限公司	洛阳轴研科技股份有限公司
轴研科技	洛阳轴研科技股份有限公司
锦州银行	锦州银行
锦州银行	锦州银行
福建龙溪轴承(集团)股份有限公司	福建龙溪轴承(集团)股份有限公司
龙溪股份	福建龙溪轴承(集团)股份有限公司
中化岩土工程股份有限公司	中化岩土工程股份有限公司
中化岩土	中化岩土工程股份有限公司
解放网	解放网
解放网	解放网
湖南正虹科技发展股份有限公司	湖南正虹科技发展股份有限公司
正虹科技	湖南正虹科技发展股份有限公司
隆鑫通用动力股份有限公司	隆鑫通用动力股份有限公司
隆鑫通用	隆鑫通用动力股份有限公司
河南太龙药业股份有限公司	河南太龙药业股份有限公司
太龙药业	河南太龙药业股份有限公司
广东长青（集团）股份有限公司	广东长青（集团）股份有限公司
长青集团	广东长青（集团）股份有限公司
大连天宝绿色食品股份有限公司	大连天宝绿色食品股份有限公司
天宝股份	大连天宝绿色食品股份有限公司
Verizon通讯公司简介	Verizon通讯公司简介
韦里孙通讯	Verizon通讯公司简介
桂林三金集团股份有限公司	桂林三金集团股份有限公司
桂林三金	桂林三金集团股份有限公司
北京四维图新科技股份有限公司	北京四维图新科技股份有限公司
四维图新	北京四维图新科技股份有限公司
辽源得亨股份有限公司	辽源得亨股份有限公司
ST得亨	辽源得亨股份有限公司
河北太行水泥股份有限公司	河北太行水泥股份有限公司
太行水泥	河北太行水泥股份有限公司
华泰人寿	华泰人寿
华泰人寿	华泰人寿
美国联合能源公司	美国联合能源公司
联合能源	美国联合能源公司
meirijingjixinwen	meirijingjixinwen
每日经济新闻	meirijingjixinwen
烟台新潮实业股份有限公司	烟台新潮实业股份有限公司
新潮实业	烟台新潮实业股份有限公司
四川保宁醋有限公司	四川保宁醋有限公司
保宁醋	四川保宁醋有限公司
珠海港股份有限公司	珠海港股份有限公司
珠海港	珠海港股份有限公司
北京开心人信息技术有限公司	北京开心人信息技术有限公司
开心网	北京开心人信息技术有限公司
山东省药用玻璃股份有限公司	山东省药用玻璃股份有限公司
山东药玻	山东省药用玻璃股份有限公司
江苏宏达新材料股份有限公司	江苏宏达新材料股份有限公司
宏达新材	江苏宏达新材料股份有限公司
武汉华信高新技术股份有限公司	武汉华信高新技术股份有限公司
华信股份	武汉华信高新技术股份有限公司
宁夏中银绒业股份有限公司	宁夏中银绒业股份有限公司
中银绒业	宁夏中银绒业股份有限公司
广州御银科技股份有限公司	广州御银科技股份有限公司
御银股份	广州御银科技股份有限公司
合肥美亚光电技术股份有限公司	合肥美亚光电技术股份有限公司
美亚光电	合肥美亚光电技术股份有限公司
上海景瑞地产集团股份有限公司	上海景瑞地产集团股份有限公司
景瑞地产	上海景瑞地产集团股份有限公司
美国瓦莱罗能源公司	美国瓦莱罗能源公司
瓦莱罗能源	美国瓦莱罗能源公司
天舟文化股份有限公司	天舟文化股份有限公司
天舟文化	天舟文化股份有限公司
兴业证券股份有限公司	兴业证券股份有限公司
兴业证券	兴业证券股份有限公司
北京金一文化发展股份有限公司	北京金一文化发展股份有限公司
金一文化	北京金一文化发展股份有限公司
KentuckyFriedChicken	KentuckyFriedChicken
肯德基	KentuckyFriedChicken
汇添富基金管理有限公司	汇添富基金管理有限公司
汇添富基金	汇添富基金管理有限公司
河南省汉威电子有限公司	河南省汉威电子有限公司
汉威电子	河南省汉威电子有限公司
国民技术股份有限公司	国民技术股份有限公司
国民技术	国民技术股份有限公司
美国西尔斯公司	美国西尔斯公司
西尔斯	美国西尔斯公司
大河网	大河网
大河网	大河网
凌云工业股份有限公司	凌云工业股份有限公司
凌云股份	凌云工业股份有限公司
三变科技股份有限公司	三变科技股份有限公司
三变科技	三变科技股份有限公司
中国人民健康保险股份有限公司	中国人民健康保险股份有限公司
人保健康	中国人民健康保险股份有限公司
人人乐商业集团	人人乐商业集团
人人乐集团	人人乐商业集团
安徽辉隆农资集团股份有限公司	安徽辉隆农资集团股份有限公司
辉隆股份	安徽辉隆农资集团股份有限公司
融海典当公司	融海典当公司
融海典当	融海典当公司
深圳市漫步者科技股份有限公司	深圳市漫步者科技股份有限公司
漫步者	深圳市漫步者科技股份有限公司
甘肃刚泰控股(集团)股份有限公司	甘肃刚泰控股(集团)股份有限公司
刚泰控股	甘肃刚泰控股(集团)股份有限公司
光大永明人寿保险有限公司	光大永明人寿保险有限公司
光大永明人寿	光大永明人寿保险有限公司
国联安基金管理有限公司	国联安基金管理有限公司
国联安.*国联安基金	国联安基金管理有限公司
红杉资本	红杉资本
红杉资本	红杉资本
信达澳银基金管理有限公司	信达澳银基金管理有限公司
信达澳银.*信达澳银基金	信达澳银基金管理有限公司
招商局地产控股股份有限公司	招商局地产控股股份有限公司
招商地产	招商局地产控股股份有限公司
上海同济科技实业股份有限公司	上海同济科技实业股份有限公司
同济科技	上海同济科技实业股份有限公司
利群集团	利群集团
利群集团	利群集团
如家酒店连锁	如家酒店连锁
如家	如家酒店连锁
挪威石油公司	挪威石油公司
国家石油	挪威石油公司
广东群兴玩具股份有限公司	广东群兴玩具股份有限公司
群兴玩具	广东群兴玩具股份有限公司
上海普利特复合材料股份有限公司	上海普利特复合材料股份有限公司
普利特	上海普利特复合材料股份有限公司
武汉武商集团股份有限公司	武汉武商集团股份有限公司
武商集团.*鄂武商A.*鄂武商Ａ	武汉武商集团股份有限公司
中远航运股份有限公司	中远航运股份有限公司
中远航运	中远航运股份有限公司
新疆冠农果茸集团股份有限公司	新疆冠农果茸集团股份有限公司
冠农股份	新疆冠农果茸集团股份有限公司
亨通集团有限公司	亨通集团有限公司
亨通集团	亨通集团有限公司
江西长运股份有限公司	江西长运股份有限公司
江西长运	江西长运股份有限公司
宁波理工监测科技股份有限公司	宁波理工监测科技股份有限公司
理工监测	宁波理工监测科技股份有限公司
无锡华东重型机械股份有限公司	无锡华东重型机械股份有限公司
华东重机	无锡华东重型机械股份有限公司
黑牡丹(集团)股份有限公司	黑牡丹(集团)股份有限公司
黑牡丹	黑牡丹(集团)股份有限公司
珠海恒基达鑫国际化工仓储股份有限公司	珠海恒基达鑫国际化工仓储股份有限公司
恒基达鑫	珠海恒基达鑫国际化工仓储股份有限公司
江苏通光电子线缆股份有限公司	江苏通光电子线缆股份有限公司
通光线缆	江苏通光电子线缆股份有限公司
昆明钢铁集团有限责任公司	昆明钢铁集团有限责任公司
昆钢集团	昆明钢铁集团有限责任公司
zhengquanshibao	zhengquanshibao
证券时报	zhengquanshibao
美国麦克森公司	美国麦克森公司
麦克森	美国麦克森公司
新华都购物广场股份有限公司	新华都购物广场股份有限公司
新华都	新华都购物广场股份有限公司
上海宏盛科技发展股份有限公司	上海宏盛科技发展股份有限公司
ST宏盛	上海宏盛科技发展股份有限公司
紫光集团有限公司	紫光集团有限公司
紫光集团	紫光集团有限公司
百盛百货	百盛百货
百盛百货	百盛百货
永高股份有限公司	永高股份有限公司
永高股份	永高股份有限公司
罗牛山股份有限公司	罗牛山股份有限公司
罗牛山	罗牛山股份有限公司
云南罗平锌电股份有限公司	云南罗平锌电股份有限公司
罗平锌电	云南罗平锌电股份有限公司
上海纺织控股（集团）公司	上海纺织控股（集团）公司
上海纺织	上海纺织控股（集团）公司
鹏欣环球资源股份有限公司	鹏欣环球资源股份有限公司
鹏欣资源	鹏欣环球资源股份有限公司
广东梅雁水电股份有限公司	广东梅雁水电股份有限公司
\\*ST梅雁	广东梅雁水电股份有限公司
吉林化纤股份有限公司	吉林化纤股份有限公司
吉林化纤	吉林化纤股份有限公司
中国长江动力公司（集团）	中国长江动力公司（集团）
中国长江动力公司（集团）	中国长江动力公司（集团）
新东方教育科技集团	新东方教育科技集团
新东方	新东方教育科技集团
深圳雷柏科技股份有限公司	深圳雷柏科技股份有限公司
雷柏科技	深圳雷柏科技股份有限公司
宝鸡钛业股份有限公司	宝鸡钛业股份有限公司
宝钛股份	宝鸡钛业股份有限公司
北京利德曼生化股份有限公司	北京利德曼生化股份有限公司
利德曼	北京利德曼生化股份有限公司
安徽水利开发股份有限公司	安徽水利开发股份有限公司
安徽水利	安徽水利开发股份有限公司
安徽鸿路钢结构(集团)股份有限公司	安徽鸿路钢结构(集团)股份有限公司
鸿路钢构	安徽鸿路钢结构(集团)股份有限公司
山东丽鹏股份有限公司	山东丽鹏股份有限公司
丽鹏股份	山东丽鹏股份有限公司
青海互助青稞酒股份有限公司	青海互助青稞酒股份有限公司
青青稞酒	青海互助青稞酒股份有限公司
上海天玑科技股份有限公司	上海天玑科技股份有限公司
天玑科技	上海天玑科技股份有限公司
深圳市大族激光科技股份有限公司	深圳市大族激光科技股份有限公司
大族激光	深圳市大族激光科技股份有限公司
江苏阳光股份有限公司	江苏阳光股份有限公司
江苏阳光	江苏阳光股份有限公司
东芝有限公司	东芝有限公司
东芝	东芝有限公司
美国邮政总局	美国邮政总局
美国邮政	美国邮政总局
Tiffany	Tiffany
蒂芙尼	Tiffany
纪源资本	纪源资本
纪源资本	纪源资本
中百控股集团股份有限公司	中百控股集团股份有限公司
中百集团	中百控股集团股份有限公司
猴王股份有限公司	猴王股份有限公司
猴王股份.*\\*ST猴王	猴王股份有限公司
经纬纺织机械股份有限公司	经纬纺织机械股份有限公司
经纬纺机	经纬纺织机械股份有限公司
惠州中京电子科技股份有限公司	惠州中京电子科技股份有限公司
中京电子	惠州中京电子科技股份有限公司
辽宁曙光汽车集团股份有限公司	辽宁曙光汽车集团股份有限公司
曙光股份	辽宁曙光汽车集团股份有限公司
山西国阳新能股份有限公司	山西国阳新能股份有限公司
国阳新能	山西国阳新能股份有限公司
杭州巨星科技股份有限公司	杭州巨星科技股份有限公司
巨星科技	杭州巨星科技股份有限公司
广药集团	广药集团
广药集团	广药集团
东安黑豹股份有限公司	东安黑豹股份有限公司
东安黑豹	东安黑豹股份有限公司
富奥汽车零部件股份有限公司	富奥汽车零部件股份有限公司
富奥股份	富奥汽车零部件股份有限公司
北京蓝色光标品牌管理顾问股份有限公司	北京蓝色光标品牌管理顾问股份有限公司
蓝色光标	北京蓝色光标品牌管理顾问股份有限公司
新希望六和股份有限公司	新希望六和股份有限公司
新希望	新希望六和股份有限公司
中国人寿保险股份有限公司	中国人寿保险股份有限公司
中国人寿	中国人寿保险股份有限公司
青岛银行	青岛银行
青岛银行	青岛银行
上海金丰投资股份有限公司	上海金丰投资股份有限公司
金丰投资	上海金丰投资股份有限公司
中国民生银行股份有限公司	中国民生银行股份有限公司
民生银行	中国民生银行股份有限公司
亚信公司	亚信公司
亚信科技	亚信公司
舒泰神(北京)生物制药股份有限公司	舒泰神(北京)生物制药股份有限公司
舒泰神	舒泰神(北京)生物制药股份有限公司
葛兰素史克公司	葛兰素史克公司
葛兰素史克公司	葛兰素史克公司
Google公司	Google公司
谷歌	Google公司
西安旅游股份有限公司	西安旅游股份有限公司
西安旅游	西安旅游股份有限公司
北京电视台	北京电视台
北京电视台	北京电视台
保利房地产集团股份有限公司	保利房地产集团股份有限公司
保利地产	保利房地产集团股份有限公司
天津红日药业股份有限公司	天津红日药业股份有限公司
红日药业	天津红日药业股份有限公司
光明乳业股份有限公司	光明乳业股份有限公司
光明乳业	光明乳业股份有限公司
黑龙江飞鹤乳业有限公司	黑龙江飞鹤乳业有限公司
飞鹤乳业	黑龙江飞鹤乳业有限公司
中海发展股份有限公司	中海发展股份有限公司
中海发展	中海发展股份有限公司
北京航天长峰股份有限公司	北京航天长峰股份有限公司
航天长峰	北京航天长峰股份有限公司
AmericanInternationalGroup	AmericanInternationalGroup
美国国际集团	AmericanInternationalGroup
松德机械股份有限公司	松德机械股份有限公司
松德股份	松德机械股份有限公司
深圳广田装饰集团股份有限公司	深圳广田装饰集团股份有限公司
广田股份	深圳广田装饰集团股份有限公司
广州港集团有限公司	广州港集团有限公司
广州港	广州港集团有限公司
山东省章丘鼓风机股份有限公司	山东省章丘鼓风机股份有限公司
山东章鼓	山东省章丘鼓风机股份有限公司
江苏高力集团有限公司	江苏高力集团有限公司
江苏高力	江苏高力集团有限公司
烽火通信科技股份有限公司	烽火通信科技股份有限公司
烽火通信	烽火通信科技股份有限公司
中山公用事业集团股份有限公司	中山公用事业集团股份有限公司
中山公用	中山公用事业集团股份有限公司
邦讯技术股份有限公司	邦讯技术股份有限公司
邦讯技术	邦讯技术股份有限公司
武汉中联药业集团股份有限公司	武汉中联药业集团股份有限公司
中联药业	武汉中联药业集团股份有限公司
中国海外发展有限公司	中国海外发展有限公司
中国海外发展	中国海外发展有限公司
广西桂东电力股份有限公司	广西桂东电力股份有限公司
桂东电力	广西桂东电力股份有限公司
象集团食品有限公司	象集团食品有限公司
白象食品集团	象集团食品有限公司
江苏澄星磷化工股份有限公司	江苏澄星磷化工股份有限公司
澄星股份	江苏澄星磷化工股份有限公司
浙江中国轻纺城集团股份有限公司	浙江中国轻纺城集团股份有限公司
轻纺城	浙江中国轻纺城集团股份有限公司
瓦房店轴承股份有限公司	瓦房店轴承股份有限公司
瓦轴股份.*瓦轴Ｂ	瓦房店轴承股份有限公司
美的集团股份有限公司	美的集团股份有限公司
美的集团	美的集团股份有限公司
金花企业集团股份有限公司	金花企业集团股份有限公司
ST金花	金花企业集团股份有限公司
华润双鹤药业股份有限公司	华润双鹤药业股份有限公司
华润双鹤	华润双鹤药业股份有限公司
广东科达机电股份有限公司	广东科达机电股份有限公司
科达机电	广东科达机电股份有限公司
广州立白企业集团有限公司	广州立白企业集团有限公司
立白集团	广州立白企业集团有限公司
扬州扬杰电子科技股份有限公司	扬州扬杰电子科技股份有限公司
扬杰科技	扬州扬杰电子科技股份有限公司
江西正邦科技股份有限公司	江西正邦科技股份有限公司
正邦科技	江西正邦科技股份有限公司
信诚人寿保险有限公司	信诚人寿保险有限公司
信诚人寿保险	信诚人寿保险有限公司
齐鲁银行股份有限公司	齐鲁银行股份有限公司
齐鲁银行	齐鲁银行股份有限公司
江西赣锋锂业股份有限公司	江西赣锋锂业股份有限公司
赣锋锂业	江西赣锋锂业股份有限公司
新疆天山水泥股份有限公司	新疆天山水泥股份有限公司
天山股份	新疆天山水泥股份有限公司
航天晨光股份有限公司	航天晨光股份有限公司
航天晨光	航天晨光股份有限公司
北京鼎汉技术股份有限公司	北京鼎汉技术股份有限公司
鼎汉技术	北京鼎汉技术股份有限公司
松辽汽车股份有限公司	松辽汽车股份有限公司
松辽汽车	松辽汽车股份有限公司
浙江水晶光电科技股份有限公司	浙江水晶光电科技股份有限公司
水晶光电	浙江水晶光电科技股份有限公司
中国国际技术智力合作公司	中国国际技术智力合作公司
中智公司	中国国际技术智力合作公司
三胞集团	三胞集团
三胞集团	三胞集团
山东地矿股份有限公司	山东地矿股份有限公司
山东地矿	山东地矿股份有限公司
中国联合网络通信股份有限公司	中国联合网络通信股份有限公司
中国联通	中国联合网络通信股份有限公司
安徽盛运环保(集团)股份有限公司	安徽盛运环保(集团)股份有限公司
盛运股份	安徽盛运环保(集团)股份有限公司
山东东方海洋科技股份有限公司	山东东方海洋科技股份有限公司
东方海洋	山东东方海洋科技股份有限公司
日本丸红株式会社	日本丸红株式会社
丸红	日本丸红株式会社
广东金曼集团股份有限公司	广东金曼集团股份有限公司
粤金曼	广东金曼集团股份有限公司
宁波先锋新材料股份有限公司	宁波先锋新材料股份有限公司
先锋新材	宁波先锋新材料股份有限公司
德国拜耳集团	德国拜耳集团
拜耳	德国拜耳集团
常柴股份有限公司	常柴股份有限公司
苏常柴.*苏常柴A.*苏常柴Ａ	常柴股份有限公司
陕西航天动力高科技股份有限公司	陕西航天动力高科技股份有限公司
航天动力	陕西航天动力高科技股份有限公司
中国基建投资有限公司	中国基建投资有限公司
中国基建投资	中国基建投资有限公司
京华时报	京华时报
京华时报	京华时报
恒生电子股份有限公司	恒生电子股份有限公司
恒生电子	恒生电子股份有限公司
四川腾中重工机械有限公司	四川腾中重工机械有限公司
腾中重工	四川腾中重工机械有限公司
上海益民商业集团股份有限公司	上海益民商业集团股份有限公司
益民集团	上海益民商业集团股份有限公司
安徽六国化工股份有限公司	安徽六国化工股份有限公司
六国化工	安徽六国化工股份有限公司
五洲明珠股份有限公司	五洲明珠股份有限公司
五洲明珠	五洲明珠股份有限公司
联化科技股份有限公司	联化科技股份有限公司
联化科技	联化科技股份有限公司
江汉石油钻头股份有限公司	江汉石油钻头股份有限公司
江钻股份	江汉石油钻头股份有限公司
南京熊猫电子股份有限公司	南京熊猫电子股份有限公司
南京熊猫	南京熊猫电子股份有限公司
重庆建设摩托车股份有限公司	重庆建设摩托车股份有限公司
建设摩托.*\\*ST建摩B	重庆建设摩托车股份有限公司
袁隆平农业高科技股份有限公司	袁隆平农业高科技股份有限公司
隆平高科	袁隆平农业高科技股份有限公司
华域汽车系统股份有限公司	华域汽车系统股份有限公司
华域汽车.*巴士股份	华域汽车系统股份有限公司
攀钢集团重庆钛业股份有限公司	攀钢集团重庆钛业股份有限公司
攀渝钛业	攀钢集团重庆钛业股份有限公司
中国信达资产管理公司	中国信达资产管理公司
信达资产	中国信达资产管理公司
北京首旅酒店(集团)股份有限公司	北京首旅酒店(集团)股份有限公司
首旅酒店	北京首旅酒店(集团)股份有限公司
日本小松公司	日本小松公司
小松	日本小松公司
三九医药股份有限公司	三九医药股份有限公司
三九医药	三九医药股份有限公司
海通食品集团股份有限公司	海通食品集团股份有限公司
海通集团	海通食品集团股份有限公司
东海证券有限责任公司	东海证券有限责任公司
东海证券	东海证券有限责任公司
瑞士再保险公司	瑞士再保险公司
瑞士再保险公司	瑞士再保险公司
重庆渝能泰山电线电缆有限公司	重庆渝能泰山电线电缆有限公司
渝能泰山	重庆渝能泰山电线电缆有限公司
施恩广州婴幼儿营养品有限公司	施恩广州婴幼儿营养品有限公司
施恩	施恩广州婴幼儿营养品有限公司
柳州钢铁股份有限公司	柳州钢铁股份有限公司
柳钢股份	柳州钢铁股份有限公司
首创证券有限责任公司	首创证券有限责任公司
首创证券	首创证券有限责任公司
北京首钢股份有限公司	北京首钢股份有限公司
首钢股份	北京首钢股份有限公司
上海新先锋药业有限公	上海新先锋药业有限公
新先锋	上海新先锋药业有限公
成都天保重型装备股份有限公司	成都天保重型装备股份有限公司
天保重装	成都天保重型装备股份有限公司
杭州民生药业集团有限公司	杭州民生药业集团有限公司
民生药业	杭州民生药业集团有限公司
陕西延长石油化建股份有限公司	陕西延长石油化建股份有限公司
延长化建	陕西延长石油化建股份有限公司
金字火腿股份有限公司	金字火腿股份有限公司
金字火腿	金字火腿股份有限公司
四川吉峰农机连锁股份有限公司	四川吉峰农机连锁股份有限公司
吉峰农机	四川吉峰农机连锁股份有限公司
昆明云内动力股份有限公司	昆明云内动力股份有限公司
云内动力	昆明云内动力股份有限公司
山东中际电工装备股份有限公司	山东中际电工装备股份有限公司
中际装备	山东中际电工装备股份有限公司
融通基金管理有限公司	融通基金管理有限公司
融通基金	融通基金管理有限公司
长城科技股份有限公司	长城科技股份有限公司
长城科技	长城科技股份有限公司
朝日啤酒株式会社	朝日啤酒株式会社
朝日啤酒	朝日啤酒株式会社
福州汇林典当行	福州汇林典当行
汇林典当	福州汇林典当行
毕马威	毕马威
毕马威	毕马威
福建实达集团股份有限公司	福建实达集团股份有限公司
实达集团.*ST实达	福建实达集团股份有限公司
施耐德电气集团有限公司	施耐德电气集团有限公司
施耐德电气	施耐德电气集团有限公司
英国石油公司	英国石油公司
BP	英国石油公司
中国铁路物资总公司	中国铁路物资总公司
中铁物资	中国铁路物资总公司
蚂蚁互动网络技术有限公司	蚂蚁互动网络技术有限公司
蚂蚁社区	蚂蚁互动网络技术有限公司
河南新飞电器有限公司	河南新飞电器有限公司
新飞	河南新飞电器有限公司
浙江乔治白服饰股份有限公司	浙江乔治白服饰股份有限公司
乔治白	浙江乔治白服饰股份有限公司
中国旅游报	中国旅游报
中国旅游报	中国旅游报
国盛证券有限责任公司	国盛证券有限责任公司
国盛证券	国盛证券有限责任公司
中国港中旅集团公司	中国港中旅集团公司
港中旅	中国港中旅集团公司
北京华联综合超市股份有限公司	北京华联综合超市股份有限公司
华联综超	北京华联综合超市股份有限公司
山西振东制药股份有限公司	山西振东制药股份有限公司
振东制药	山西振东制药股份有限公司
中联重科股份有限公司	中联重科股份有限公司
中联重科	中联重科股份有限公司
中国经济时报	中国经济时报
中国经济时报	中国经济时报
亿利资源集团	亿利资源集团
亿利资源	亿利资源集团
利欧集团股份有限公司	利欧集团股份有限公司
利欧股份	利欧集团股份有限公司
合肥荣事达三洋电器股份有限公司	合肥荣事达三洋电器股份有限公司
合肥三洋	合肥荣事达三洋电器股份有限公司
南京江宇建设集团有限责任公司	南京江宇建设集团有限责任公司
江宇集团	南京江宇建设集团有限责任公司
中银保险有限公司	中银保险有限公司
中银保险	中银保险有限公司
苏州新区高新技术产业股份有限公司	苏州新区高新技术产业股份有限公司
苏州高新	苏州新区高新技术产业股份有限公司
鼎和财产保险股份有限公司	鼎和财产保险股份有限公司
鼎和财险	鼎和财产保险股份有限公司
光明集团家具股份有限公司	光明集团家具股份有限公司
SST光明	光明集团家具股份有限公司
中国船舶重工股份有限公司	中国船舶重工股份有限公司
中国重工.*中船重工	中国船舶重工股份有限公司
北京王府井百货集团股份有限公司	北京王府井百货集团股份有限公司
王府井	北京王府井百货集团股份有限公司
河北常山生化药业股份有限公司	河北常山生化药业股份有限公司
常山药业	河北常山生化药业股份有限公司
来宝集团有限公司	来宝集团有限公司
来宝集团	来宝集团有限公司
深圳市得润电子股份有限公司	深圳市得润电子股份有限公司
得润电子	深圳市得润电子股份有限公司
富春通信股份有限公司	富春通信股份有限公司
富春通信	富春通信股份有限公司
林海股份有限公司	林海股份有限公司
林海股份	林海股份有限公司
株洲时代新材料科技股份有限公司	株洲时代新材料科技股份有限公司
时代新材	株洲时代新材料科技股份有限公司
福建榕基软件股份有限公司	福建榕基软件股份有限公司
榕基软件	福建榕基软件股份有限公司
夏新电子股份有限公司	夏新电子股份有限公司
\\*ST夏新	夏新电子股份有限公司
甘肃靖远煤电股份有限公司	甘肃靖远煤电股份有限公司
靖远煤电	甘肃靖远煤电股份有限公司
山东三维石化工程股份有限公司	山东三维石化工程股份有限公司
三维工程	山东三维石化工程股份有限公司
海虹企业控股股份有限公司	海虹企业控股股份有限公司
海虹控股	海虹企业控股股份有限公司
新大洲控股股份有限公司	新大洲控股股份有限公司
新大洲.*新大洲A.*新大洲Ａ	新大洲控股股份有限公司
福建南平南孚电池有限公司	福建南平南孚电池有限公司
南孚	福建南平南孚电池有限公司
重庆南方集团有限公司	重庆南方集团有限公司
南方集团	重庆南方集团有限公司
网易公司	网易公司
网易	网易公司
四川里伍铜业股份有限公司	四川里伍铜业股份有限公司
里伍铜业	四川里伍铜业股份有限公司
汇丰保险	汇丰保险
汇丰保险	汇丰保险
公牛电器有限公司	公牛电器有限公司
公牛电器	公牛电器有限公司
北京深华新股份有限公司	北京深华新股份有限公司
深华新	北京深华新股份有限公司
华远地产股份有限公司	华远地产股份有限公司
华远地产	华远地产股份有限公司
四川金宇汽车城(集团)股份有限公司	四川金宇汽车城(集团)股份有限公司
金宇车城	四川金宇汽车城(集团)股份有限公司
山东滨化集团	山东滨化集团
山东滨化集团	山东滨化集团
淄博齐翔腾达化工股份有限公司	淄博齐翔腾达化工股份有限公司
齐翔腾达	淄博齐翔腾达化工股份有限公司
阜昌典当行	阜昌典当行
阜昌典当	阜昌典当行
烟台万润精细化工股份有限公司	烟台万润精细化工股份有限公司
烟台万润	烟台万润精细化工股份有限公司
广东省高速公路发展股份有限公司	广东省高速公路发展股份有限公司
粤高速.*粤高速Ａ	广东省高速公路发展股份有限公司
上海振华港口机械集团股份有限公司	上海振华港口机械集团股份有限公司
振华港机	上海振华港口机械集团股份有限公司
山东圣阳电源股份有限公司	山东圣阳电源股份有限公司
圣阳股份	山东圣阳电源股份有限公司
浙江阳光照明电器集团股份有限公司	浙江阳光照明电器集团股份有限公司
阳光照明	浙江阳光照明电器集团股份有限公司
大连大显集团有限公司	大连大显集团有限公司
大显集团	大连大显集团有限公司
上海锐奇工具股份有限公司	上海锐奇工具股份有限公司
锐奇股份	上海锐奇工具股份有限公司
国机汽车股份有限公司	国机汽车股份有限公司
国机汽车	国机汽车股份有限公司
中企动力科技集团股份有限公司	中企动力科技集团股份有限公司
中企动力	中企动力科技集团股份有限公司
河南豫光金铅股份有限公司	河南豫光金铅股份有限公司
豫光金铅	河南豫光金铅股份有限公司
哈药集团股份有限公司	哈药集团股份有限公司
哈药股份	哈药集团股份有限公司
西洋集团	西洋集团
西洋集团	西洋集团
宝诚投资股份有限公司	宝诚投资股份有限公司
宝诚股份	宝诚投资股份有限公司
国电电力发展股份有限公司	国电电力发展股份有限公司
国电电力	国电电力发展股份有限公司
北京天略盛世拍卖有限责任公司	北京天略盛世拍卖有限责任公司
天略盛世拍卖	北京天略盛世拍卖有限责任公司
深圳兆日科技股份有限公司	深圳兆日科技股份有限公司
兆日科技	深圳兆日科技股份有限公司
中国海运集团总公司	中国海运集团总公司
中国海运	中国海运集团总公司
昆山金利表面材料应用科技股份有限公司	昆山金利表面材料应用科技股份有限公司
金利科技	昆山金利表面材料应用科技股份有限公司
山西潞安环保能源开发股份有限公司	山西潞安环保能源开发股份有限公司
潞安环能	山西潞安环保能源开发股份有限公司
山东高速公路股份有限公司	山东高速公路股份有限公司
山东高速	山东高速公路股份有限公司
江西鑫新实业股份有限公司	江西鑫新实业股份有限公司
鑫新股份	江西鑫新实业股份有限公司
内蒙古兴业矿业股份有限公司	内蒙古兴业矿业股份有限公司
兴业矿业	内蒙古兴业矿业股份有限公司
上海实业发展股份有限公司	上海实业发展股份有限公司
上实发展	上海实业发展股份有限公司
美国富国银行	美国富国银行
富国银行	美国富国银行
国家开发银行股份有限公司	国家开发银行股份有限公司
国家开发银行	国家开发银行股份有限公司
远洋地产	远洋地产
远洋地产	远洋地产
上海华源企业发展股份有限公司	上海华源企业发展股份有限公司
ST源发	上海华源企业发展股份有限公司
DTZ戴德梁行	DTZ戴德梁行
戴德梁行	DTZ戴德梁行
山东法因数控机械股份有限公司	山东法因数控机械股份有限公司
法因数控	山东法因数控机械股份有限公司
南京青和投资集团有限公司	南京青和投资集团有限公司
青和集团	南京青和投资集团有限公司
索尼爱立信移动通信产品（中国）有限公司	索尼爱立信移动通信产品（中国）有限公司
索尼爱立信	索尼爱立信移动通信产品（中国）有限公司
加拿大庞巴迪公司	加拿大庞巴迪公司
庞巴迪	加拿大庞巴迪公司
环球网	环球网
环球网	环球网
广东冠豪高新技术股份有限公司	广东冠豪高新技术股份有限公司
冠豪高新	广东冠豪高新技术股份有限公司
四川在线	四川在线
四川在线	四川在线
山东博汇纸业股份有限公司	山东博汇纸业股份有限公司
博汇纸业	山东博汇纸业股份有限公司
深圳市实益达科技股份有限公司	深圳市实益达科技股份有限公司
实益达	深圳市实益达科技股份有限公司
云南马龙产业集团股份有限公司	云南马龙产业集团股份有限公司
ST马龙	云南马龙产业集团股份有限公司
西安飞机工业集团有限责任公司	西安飞机工业集团有限责任公司
西飞工业集团	西安飞机工业集团有限责任公司
上海海得控制系统股份有限公司	上海海得控制系统股份有限公司
海得控制	上海海得控制系统股份有限公司
希慎兴业有限公司	希慎兴业有限公司
希慎兴业	希慎兴业有限公司
四川科新机电股份有限公司	四川科新机电股份有限公司
科新机电	四川科新机电股份有限公司
中国高科集团股份有限公司	中国高科集团股份有限公司
中国高科	中国高科集团股份有限公司
西北轴承股份有限公司	西北轴承股份有限公司
西北轴承	西北轴承股份有限公司
无锡小天鹅股份有限公司	无锡小天鹅股份有限公司
小天鹅.*小天鹅A.*小天鹅Ａ	无锡小天鹅股份有限公司
GoogleInc.	GoogleInc.
Google	GoogleInc.
北京京能电力股份有限公司	北京京能电力股份有限公司
京能电力	北京京能电力股份有限公司
财华网	财华网
财华网	财华网
广东星辉车模股份有限公司	广东星辉车模股份有限公司
星辉车模	广东星辉车模股份有限公司
上海嘉麟杰纺织品股份有限公司	上海嘉麟杰纺织品股份有限公司
嘉麟杰	上海嘉麟杰纺织品股份有限公司
深圳南山热电股份有限公司	深圳南山热电股份有限公司
深南电.*深南电A.*深南电Ａ	深圳南山热电股份有限公司
云南煤业能源股份有限公司	云南煤业能源股份有限公司
云煤能源	云南煤业能源股份有限公司
万泽实业股份有限公司	万泽实业股份有限公司
万泽股份	万泽实业股份有限公司
智基创投	智基创投
智基创投	智基创投
四川岷江水利电力股份有限公司	四川岷江水利电力股份有限公司
岷江水电	四川岷江水利电力股份有限公司
新疆天富热电股份有限公司	新疆天富热电股份有限公司
天富热电	新疆天富热电股份有限公司
中海海南海盛船务股份有限公司	中海海南海盛船务股份有限公司
中海海盛	中海海南海盛船务股份有限公司
保利房地产(集团)股份有限公司	保利房地产(集团)股份有限公司
保利地产	保利房地产(集团)股份有限公司
福建省燕京惠泉啤酒股份有限公司	福建省燕京惠泉啤酒股份有限公司
惠泉啤酒	福建省燕京惠泉啤酒股份有限公司
珠海华发实业股份有限公司	珠海华发实业股份有限公司
华发股份	珠海华发实业股份有限公司
华新水泥股份有限公司	华新水泥股份有限公司
华新水泥	华新水泥股份有限公司
沈阳金山能源股份有限公司	沈阳金山能源股份有限公司
金山股份	沈阳金山能源股份有限公司
海南康芝药业股份有限公司	海南康芝药业股份有限公司
康芝药业	海南康芝药业股份有限公司
日本永旺集团	日本永旺集团
永旺	日本永旺集团
贵州航天电器股份有限公司	贵州航天电器股份有限公司
航天电器	贵州航天电器股份有限公司
哈药集团有限公司	哈药集团有限公司
哈药集团	哈药集团有限公司
江苏联发纺织股份有限公司	江苏联发纺织股份有限公司
联发股份	江苏联发纺织股份有限公司
七匹狼实业股份有限公司	七匹狼实业股份有限公司
七匹狼	七匹狼实业股份有限公司
比亚迪股份有限公司	比亚迪股份有限公司
比亚迪	比亚迪股份有限公司
西藏矿业发展股份有限公司	西藏矿业发展股份有限公司
西藏矿业	西藏矿业发展股份有限公司
浙江海力生集团有限公司	浙江海力生集团有限公司
海力生	浙江海力生集团有限公司
安徽江淮汽车股份有限公司	安徽江淮汽车股份有限公司
江淮汽车	安徽江淮汽车股份有限公司
东日本铁路公司	东日本铁路公司
JR东日本	东日本铁路公司
沈阳惠天热电股份有限公司	沈阳惠天热电股份有限公司
惠天热电	沈阳惠天热电股份有限公司
建新矿业股份有限责任公司	建新矿业股份有限责任公司
建新矿业	建新矿业股份有限责任公司
浙江广厦股份有限公司	浙江广厦股份有限公司
浙江广厦	浙江广厦股份有限公司
四川禾嘉股份有限公司	四川禾嘉股份有限公司
禾嘉股份	四川禾嘉股份有限公司
苏州安洁科技股份有限公司	苏州安洁科技股份有限公司
安洁科技	苏州安洁科技股份有限公司
宝山钢铁股份有限公司	宝山钢铁股份有限公司
宝钢股份	宝山钢铁股份有限公司
软银赛富基金	软银赛富基金
赛富基金	软银赛富基金
四川沱牌曲酒股份有限公司	四川沱牌曲酒股份有限公司
沱牌曲酒	四川沱牌曲酒股份有限公司
广东金明精机股份有限公司	广东金明精机股份有限公司
金明精机	广东金明精机股份有限公司
雅居乐地产控股有限公司	雅居乐地产控股有限公司
雅居乐	雅居乐地产控股有限公司
马钢国际经济贸易总公司	马钢国际经济贸易总公司
马钢国际经济贸易总公司	马钢国际经济贸易总公司
江苏秀强玻璃工艺股份有限公司	江苏秀强玻璃工艺股份有限公司
秀强股份	江苏秀强玻璃工艺股份有限公司
普利司通企业集团	普利司通企业集团
普利司通	普利司通企业集团
雅本化学股份有限公司	雅本化学股份有限公司
雅本化学	雅本化学股份有限公司
光一科技股份有限公司	光一科技股份有限公司
光一科技	光一科技股份有限公司
鲁商置业股份有限公司	鲁商置业股份有限公司
鲁商置业	鲁商置业股份有限公司
平安银行股份有限公司	平安银行股份有限公司
平安银行	平安银行股份有限公司
湖南湘邮科技股份有限公司	湖南湘邮科技股份有限公司
湘邮科技	湖南湘邮科技股份有限公司
深圳市新纶科技股份有限公司	深圳市新纶科技股份有限公司
新纶科技	深圳市新纶科技股份有限公司
江苏东华测试技术股份有限公司	江苏东华测试技术股份有限公司
东华测试	江苏东华测试技术股份有限公司
汤臣倍健股份有限公司	汤臣倍健股份有限公司
汤臣倍健	汤臣倍健股份有限公司
广州天赐高新材料股份有限公司	广州天赐高新材料股份有限公司
天赐材料	广州天赐高新材料股份有限公司
广西南方食品集团股份有限公司	广西南方食品集团股份有限公司
ST南方	广西南方食品集团股份有限公司
卧龙电气集团股份有限公司	卧龙电气集团股份有限公司
卧龙电气	卧龙电气集团股份有限公司
思八达集团公司	思八达集团公司
思八达	思八达集团公司
大连万达集团股份有限公司	大连万达集团股份有限公司
大连万达	大连万达集团股份有限公司
江苏亿通高科技股份有限公司	江苏亿通高科技股份有限公司
亿通科技	江苏亿通高科技股份有限公司
永盛集团有限公司	永盛集团有限公司
永盛集团	永盛集团有限公司
深圳市尚荣医疗股份有限公司	深圳市尚荣医疗股份有限公司
尚荣医疗	深圳市尚荣医疗股份有限公司
日本钢铁工程控股公司	日本钢铁工程控股公司
日本钢管	日本钢铁工程控股公司
天津普林电路股份有限公司	天津普林电路股份有限公司
天津普林	天津普林电路股份有限公司
无锡兴达集团	无锡兴达集团
兴达集团	无锡兴达集团
长安信息产业集团股份有限公司	长安信息产业集团股份有限公司
ST长信	长安信息产业集团股份有限公司
四川金顶集团股份有限公司	四川金顶集团股份有限公司
四川金顶	四川金顶集团股份有限公司
大亚科技股份有限公司	大亚科技股份有限公司
大亚科技	大亚科技股份有限公司
郑州华晶金刚石股份有限公司	郑州华晶金刚石股份有限公司
豫金刚石	郑州华晶金刚石股份有限公司
广西河池化工股份有限公司	广西河池化工股份有限公司
河池化工.*\\*ST河化	广西河池化工股份有限公司
深圳市长亮科技股份有限公司	深圳市长亮科技股份有限公司
长亮科技	深圳市长亮科技股份有限公司
金城造纸股份有限公司	金城造纸股份有限公司
金城股份	金城造纸股份有限公司
新华人寿保险股份有限公司	新华人寿保险股份有限公司
新华保险.*新华人寿	新华人寿保险股份有限公司
联合证券有限责任公司	联合证券有限责任公司
联合证券	联合证券有限责任公司
广州珠江实业开发股份有限公司	广州珠江实业开发股份有限公司
珠江实业	广州珠江实业开发股份有限公司
商界·评论	商界·评论
商界·评论	商界·评论
鞍山钢铁集团公司	鞍山钢铁集团公司
鞍山钢铁	鞍山钢铁集团公司
浙江华智控股股份有限公司	浙江华智控股股份有限公司
华智控股	浙江华智控股股份有限公司
深圳华侨城控股股份有限公司	深圳华侨城控股股份有限公司
华侨城A	深圳华侨城控股股份有限公司
江苏中达新材料集团股份有限公司	江苏中达新材料集团股份有限公司
中达股份	江苏中达新材料集团股份有限公司
贵州益佰制药股份有限公司	贵州益佰制药股份有限公司
益佰制药	贵州益佰制药股份有限公司
宁波戴维医疗器械股份有限公司	宁波戴维医疗器械股份有限公司
戴维医疗	宁波戴维医疗器械股份有限公司
大连北大科技集团股份有限公司	大连北大科技集团股份有限公司
\\*ST北科	大连北大科技集团股份有限公司
国药集团一致药业股份有限公司	国药集团一致药业股份有限公司
国药一致	国药集团一致药业股份有限公司
浙报传媒集团股份有限公司	浙报传媒集团股份有限公司
浙报传媒	浙报传媒集团股份有限公司
汉鼎信息科技股份有限公司	汉鼎信息科技股份有限公司
汉鼎股份	汉鼎信息科技股份有限公司
万福生科（湖南）农业开发股份有限公司	万福生科（湖南）农业开发股份有限公司
万福生科	万福生科（湖南）农业开发股份有限公司
沈机集团昆明机床股份有限公司	沈机集团昆明机床股份有限公司
昆明机床	沈机集团昆明机床股份有限公司
信诚基金管理有限公司	信诚基金管理有限公司
信诚基金	信诚基金管理有限公司
安徽口子酒业有限公司	安徽口子酒业有限公司
口子酒业	安徽口子酒业有限公司
云南城投置业股份有限公司	云南城投置业股份有限公司
云南城投	云南城投置业股份有限公司
华富基金管理有限公司	华富基金管理有限公司
华富基金	华富基金管理有限公司
中冶美利纸业股份有限公司	中冶美利纸业股份有限公司
美利纸业	中冶美利纸业股份有限公司
无锡商业大厦大东方股份有限公司	无锡商业大厦大东方股份有限公司
大东方	无锡商业大厦大东方股份有限公司
资生堂	资生堂
资生堂	资生堂
中国中煤能源股份有限公司	中国中煤能源股份有限公司
中煤能源	中国中煤能源股份有限公司
齐峰新材料股份有限公司	齐峰新材料股份有限公司
齐峰新材	齐峰新材料股份有限公司
陕西飞机工业集团有限公司	陕西飞机工业集团有限公司
陕飞工业集团	陕西飞机工业集团有限公司
深圳市海普瑞药业股份有限公司	深圳市海普瑞药业股份有限公司
海普瑞	深圳市海普瑞药业股份有限公司
三菱重工	三菱重工
三菱重工	三菱重工
江苏红豆实业股份有限公司	江苏红豆实业股份有限公司
红豆股份	江苏红豆实业股份有限公司
湖北沙隆达股份有限公司	湖北沙隆达股份有限公司
沙隆达.*沙隆达A.*沙隆达Ａ	湖北沙隆达股份有限公司
广东广州日报传媒股份有限公司	广东广州日报传媒股份有限公司
粤传媒	广东广州日报传媒股份有限公司
江苏延申生物科技	江苏延申生物科技
江苏延申生物科技	江苏延申生物科技
欣旺达电子股份有限公司	欣旺达电子股份有限公司
欣旺达	欣旺达电子股份有限公司
万利达集团有限公司	万利达集团有限公司
万利达	万利达集团有限公司
湖南千山制药机械股份有限公司	湖南千山制药机械股份有限公司
千山药机	湖南千山制药机械股份有限公司
博世集团	博世集团
博世	博世集团
南京汽轮电机集团	南京汽轮电机集团
南京汽轮	南京汽轮电机集团
通裕重工股份有限公司	通裕重工股份有限公司
通裕重工	通裕重工股份有限公司
赛迪顾问股份有限公司	赛迪顾问股份有限公司
赛迪顾问	赛迪顾问股份有限公司
广东开平春晖股份有限公司	广东开平春晖股份有限公司
春晖股份	广东开平春晖股份有限公司
山东如意科技集团	山东如意科技集团
如意科技	山东如意科技集团
天津瑞普生物技术股份有限公司	天津瑞普生物技术股份有限公司
瑞普生物	天津瑞普生物技术股份有限公司
华丽家族股份有限公司	华丽家族股份有限公司
华丽家族	华丽家族股份有限公司
金堆城钼业股份有限公司	金堆城钼业股份有限公司
金钼股份	金堆城钼业股份有限公司
北京合康亿盛变频科技股份有限公司	北京合康亿盛变频科技股份有限公司
合康变频	北京合康亿盛变频科技股份有限公司
中惠国际投资集团有限公司	中惠国际投资集团有限公司
中惠集团	中惠国际投资集团有限公司
天茂实业集团股份有限公司	天茂实业集团股份有限公司
天茂集团	天茂实业集团股份有限公司
深圳市康达尔(集团)股份有限公司	深圳市康达尔(集团)股份有限公司
康达尔	深圳市康达尔(集团)股份有限公司
湘财证券有限责任公司	湘财证券有限责任公司
湘财证券	湘财证券有限责任公司